LineKey,PrimaryKey,TRANSECT,GapStart,GapEnd,Gap,LineLengthAmount,GapMin,Measure,RecType
201A,201A,2,53,72,19,90,10,1,C
201A,201A,2,81,94,13,90,10,1,C
201A,201A,2,148,161,13,90,10,1,C
201A,201A,2,292,315,23,90,10,1,C
201A,201A,2,492,515,23,90,10,1,C
201A,201A,2,572,588,16,90,10,1,C
201A,201A,2,620,641,21,90,10,1,C
201A,201A,2,908,922,14,90,10,1,C
201A,201A,2,1050,1086,36,90,10,1,C
201A,201A,2,1195,1219,24,90,10,1,C
201A,201A,2,1367,1406,39,90,10,1,C
201A,201A,2,1428,1452,24,90,10,1,C
201A,201A,2,1586,1600,14,90,10,1,C
201A,201A,2,1620,1645,25,90,10,1,C
201A,201A,2,1690,1828,138,90,10,1,C
201A,201A,2,1855,1880,25,90,10,1,C
201A,201A,2,1896,1909,13,90,10,1,C
201A,201A,2,1923,1966,43,90,10,1,C
201A,201A,2,1973,2032,59,90,10,1,C
201A,201A,2,2066,2090,24,90,10,1,C
201A,201A,2,2130,2147,17,90,10,1,C
201A,201A,2,2204,2219,15,90,10,1,C
201A,201A,2,2775,2806,31,90,10,1,C
201A,201A,2,2858,2872,14,90,10,1,C
201A,201A,2,2930,2940,10,90,10,1,C
201A,201A,15,198,243,45,90,10,1,C
201A,201A,15,357,377,20,90,10,1,C
201A,201A,15,437,470,33,90,10,1,C
201A,201A,15,529,563,34,90,10,1,C
201A,201A,15,579,602,23,90,10,1,C
201A,201A,15,612,669,57,90,10,1,C
201A,201A,15,696,734,38,90,10,1,C
201A,201A,15,763,804,41,90,10,1,C
201A,201A,15,971,998,27,90,10,1,C
201A,201A,15,1059,1070,11,90,10,1,C
201A,201A,15,1314,1332,18,90,10,1,C
201A,201A,15,1479,1500,21,90,10,1,C
201A,201A,15,1513,1524,11,90,10,1,C
201A,201A,15,1575,1594,19,90,10,1,C
201A,201A,15,1617,1652,35,90,10,1,C
201A,201A,15,1673,1730,57,90,10,1,C
201A,201A,15,1752,1796,44,90,10,1,C
201A,201A,15,1803,1825,22,90,10,1,C
201A,201A,15,1839,1897,58,90,10,1,C
201A,201A,15,1906,1920,14,90,10,1,C
201A,201A,15,1943,1977,34,90,10,1,C
201A,201A,15,1998,2092,94,90,10,1,C
201A,201A,15,2113,2163,50,90,10,1,C
201A,201A,15,2203,2261,58,90,10,1,C
201A,201A,15,2291,2305,14,90,10,1,C
201A,201A,15,2490,2523,33,90,10,1,C
201A,201A,15,2536,2561,25,90,10,1,C
201A,201A,15,2604,2626,22,90,10,1,C
201A,201A,15,2718,2739,21,90,10,1,C
201A,201A,15,2760,2781,21,90,10,1,C
201A,201A,15,2931,2963,32,90,10,1,C
201A,201A,28,92,121,29,90,10,1,C
201A,201A,28,176,208,32,90,10,1,C
201A,201A,28,217,236,19,90,10,1,C
201A,201A,28,323,352,29,90,10,1,C
201A,201A,28,398,486,88,90,10,1,C
201A,201A,28,555,577,22,90,10,1,C
201A,201A,28,721,769,48,90,10,1,C
201A,201A,28,917,969,52,90,10,1,C
201A,201A,28,988,1057,69,90,10,1,C
201A,201A,28,1112,1145,33,90,10,1,C
201A,201A,28,1163,1238,75,90,10,1,C
201A,201A,28,1255,1291,36,90,10,1,C
201A,201A,28,1341,1375,34,90,10,1,C
201A,201A,28,1493,1524,31,90,10,1,C
201A,201A,28,1642,1674,32,90,10,1,C
201A,201A,28,1727,1746,19,90,10,1,C
201A,201A,28,1785,1829,44,90,10,1,C
201A,201A,28,1964,2032,68,90,10,1,C
201A,201A,28,2045,2073,28,90,10,1,C
201A,201A,28,2221,2255,34,90,10,1,C
201A,201A,28,2285,2307,22,90,10,1,C
201A,201A,28,2372,2406,34,90,10,1,C
201A,201A,28,2418,2435,17,90,10,1,C
201A,201A,28,2470,2492,22,90,10,1,C
201A,201A,28,2595,2611,16,90,10,1,C
201A,201A,28,2636,2670,34,90,10,1,C
201A,201A,28,2675,2685,10,90,10,1,C
201A,201A,28,2717,2749,32,90,10,1,C
201A,201A,28,2859,2872,13,90,10,1,C
201A,201A,28,2954,2974,20,90,10,1,C
201G,201G,2,0,23,23,90,10,1,C
201G,201G,2,52,114,62,90,10,1,C
201G,201G,2,132,208,76,90,10,1,C
201G,201G,2,214,271,57,90,10,1,C
201G,201G,2,277,315,38,90,10,1,C
201G,201G,2,328,339,11,90,10,1,C
201G,201G,2,390,455,65,90,10,1,C
201G,201G,2,496,547,51,90,10,1,C
201G,201G,2,597,721,124,90,10,1,C
201G,201G,2,812,831,19,90,10,1,C
201G,201G,2,871,881,10,90,10,1,C
201G,201G,2,935,963,28,90,10,1,C
201G,201G,2,1123,1150,27,90,10,1,C
201G,201G,2,1166,1184,18,90,10,1,C
201G,201G,2,1200,1238,38,90,10,1,C
201G,201G,2,1294,1309,15,90,10,1,C
201G,201G,2,1339,1379,40,90,10,1,C
201G,201G,2,1492,1513,21,90,10,1,C
201G,201G,2,1612,1686,74,90,10,1,C
201G,201G,2,1866,1889,23,90,10,1,C
201G,201G,2,1936,2010,74,90,10,1,C
201G,201G,2,2019,2038,19,90,10,1,C
201G,201G,2,2045,2069,24,90,10,1,C
201G,201G,2,2081,2121,40,90,10,1,C
201G,201G,2,2130,2146,16,90,10,1,C
201G,201G,2,2185,2196,11,90,10,1,C
201G,201G,2,2233,2331,98,90,10,1,C
201G,201G,2,2345,2366,21,90,10,1,C
201G,201G,2,2381,2415,34,90,10,1,C
201G,201G,2,2443,2510,67,90,10,1,C
201G,201G,2,2559,2598,39,90,10,1,C
201G,201G,2,2609,2675,66,90,10,1,C
201G,201G,2,2696,2708,12,90,10,1,C
201G,201G,2,2740,2800,60,90,10,1,C
201G,201G,2,2837,2855,18,90,10,1,C
201G,201G,2,2880,2899,19,90,10,1,C
201G,201G,2,2916,2932,16,90,10,1,C
201G,201G,2,2950,2960,10,90,10,1,C
201G,201G,15,150,173,23,90,10,1,C
201G,201G,15,200,217,17,90,10,1,C
201G,201G,15,268,280,12,90,10,1,C
201G,201G,15,290,305,15,90,10,1,C
201G,201G,15,414,438,24,90,10,1,C
201G,201G,15,538,561,23,90,10,1,C
201G,201G,15,591,640,49,90,10,1,C
201G,201G,15,700,725,25,90,10,1,C
201G,201G,15,730,745,15,90,10,1,C
201G,201G,15,824,845,21,90,10,1,C
201G,201G,15,889,915,26,90,10,1,C
201G,201G,15,922,940,18,90,10,1,C
201G,201G,15,945,959,14,90,10,1,C
201G,201G,15,1020,1076,56,90,10,1,C
201G,201G,15,1142,1181,39,90,10,1,C
201G,201G,15,1490,1502,12,90,10,1,C
201G,201G,15,1509,1545,36,90,10,1,C
201G,201G,15,1580,1598,18,90,10,1,C
201G,201G,15,1617,1630,13,90,10,1,C
201G,201G,15,1785,1863,78,90,10,1,C
201G,201G,15,1980,2004,24,90,10,1,C
201G,201G,15,2029,2058,29,90,10,1,C
201G,201G,15,2084,2145,61,90,10,1,C
201G,201G,15,2273,2317,44,90,10,1,C
201G,201G,15,2494,2575,81,90,10,1,C
201G,201G,15,2819,2847,28,90,10,1,C
201G,201G,15,2855,2889,34,90,10,1,C
201G,201G,15,2913,2929,16,90,10,1,C
201G,201G,15,2977,3000,23,90,10,1,C
201G,201G,28,0,26,26,90,10,1,C
201G,201G,28,115,200,85,90,10,1,C
201G,201G,28,242,277,35,90,10,1,C
201G,201G,28,345,375,30,90,10,1,C
201G,201G,28,390,415,25,90,10,1,C
201G,201G,28,493,510,17,90,10,1,C
201G,201G,28,550,584,34,90,10,1,C
201G,201G,28,597,630,33,90,10,1,C
201G,201G,28,688,800,112,90,10,1,C
201G,201G,28,809,820,11,90,10,1,C
201G,201G,28,917,1004,87,90,10,1,C
201G,201G,28,1043,1058,15,90,10,1,C
201G,201G,28,1063,1118,55,90,10,1,C
201G,201G,28,1130,1153,23,90,10,1,C
201G,201G,28,1162,1178,16,90,10,1,C
201G,201G,28,1189,1280,91,90,10,1,C
201G,201G,28,1310,1335,25,90,10,1,C
201G,201G,28,1352,1391,39,90,10,1,C
201G,201G,28,1416,1470,54,90,10,1,C
201G,201G,28,1493,1550,57,90,10,1,C
201G,201G,28,1604,1625,21,90,10,1,C
201G,201G,28,1684,1747,63,90,10,1,C
201G,201G,28,1780,1806,26,90,10,1,C
201G,201G,28,1817,1842,25,90,10,1,C
201G,201G,28,1854,1870,16,90,10,1,C
201G,201G,28,1967,2035,68,90,10,1,C
201G,201G,28,2077,2127,50,90,10,1,C
201G,201G,28,2212,2267,55,90,10,1,C
201G,201G,28,2275,2289,14,90,10,1,C
201G,201G,28,2456,2482,26,90,10,1,C
201G,201G,28,2517,2539,22,90,10,1,C
201G,201G,28,2621,2636,15,90,10,1,C
201G,201G,28,2873,2905,32,90,10,1,C
202A,202A,2,22,39,17,90,10,1,C
202A,202A,2,67,84,17,90,10,1,C
202A,202A,2,112,207,95,90,10,1,C
202A,202A,2,223,254,31,90,10,1,C
202A,202A,2,283,316,33,90,10,1,C
202A,202A,2,358,368,10,90,10,1,C
202A,202A,2,375,466,91,90,10,1,C
202A,202A,2,517,535,18,90,10,1,C
202A,202A,2,563,576,13,90,10,1,C
202A,202A,2,589,623,34,90,10,1,C
202A,202A,2,643,713,70,90,10,1,C
202A,202A,2,740,765,25,90,10,1,C
202A,202A,2,836,848,12,90,10,1,C
202A,202A,2,877,895,18,90,10,1,C
202A,202A,2,913,952,39,90,10,1,C
202A,202A,2,1020,1146,126,90,10,1,C
202A,202A,2,1177,1253,76,90,10,1,C
202A,202A,2,1263,1309,46,90,10,1,C
202A,202A,2,1406,1425,19,90,10,1,C
202A,202A,2,1460,1488,28,90,10,1,C
202A,202A,2,1515,1525,10,90,10,1,C
202A,202A,2,1543,1553,10,90,10,1,C
202A,202A,2,1620,1682,62,90,10,1,C
202A,202A,2,1705,1719,14,90,10,1,C
202A,202A,2,1749,1789,40,90,10,1,C
202A,202A,2,1820,1831,11,90,10,1,C
202A,202A,2,1853,1864,11,90,10,1,C
202A,202A,2,1909,1938,29,90,10,1,C
202A,202A,2,1984,1994,10,90,10,1,C
202A,202A,2,2019,2039,20,90,10,1,C
202A,202A,2,2072,2138,66,90,10,1,C
202A,202A,2,2181,2202,21,90,10,1,C
202A,202A,2,2283,2323,40,90,10,1,C
202A,202A,2,2358,2400,42,90,10,1,C
202A,202A,2,2420,2438,18,90,10,1,C
202A,202A,2,2492,2507,15,90,10,1,C
202A,202A,2,2729,2767,38,90,10,1,C
202A,202A,2,2791,2907,116,90,10,1,C
202A,202A,15,20,75,55,90,10,1,C
202A,202A,15,105,131,26,90,10,1,C
202A,202A,15,150,200,50,90,10,1,C
202A,202A,15,282,305,23,90,10,1,C
202A,202A,15,398,409,11,90,10,1,C
202A,202A,15,469,544,75,90,10,1,C
202A,202A,15,570,619,49,90,10,1,C
202A,202A,15,817,835,18,90,10,1,C
202A,202A,15,875,900,25,90,10,1,C
202A,202A,15,918,930,12,90,10,1,C
202A,202A,15,972,1007,35,90,10,1,C
202A,202A,15,1052,1069,17,90,10,1,C
202A,202A,15,1083,1135,52,90,10,1,C
202A,202A,15,1168,1324,156,90,10,1,C
202A,202A,15,1335,1430,95,90,10,1,C
202A,202A,15,1556,1620,64,90,10,1,C
202A,202A,15,1650,1667,17,90,10,1,C
202A,202A,15,1681,1739,58,90,10,1,C
202A,202A,15,1770,1810,40,90,10,1,C
202A,202A,15,1863,1904,41,90,10,1,C
202A,202A,15,1925,1940,15,90,10,1,C
202A,202A,15,1963,1973,10,90,10,1,C
202A,202A,15,2015,2047,32,90,10,1,C
202A,202A,15,2117,2132,15,90,10,1,C
202A,202A,15,2170,2210,40,90,10,1,C
202A,202A,15,2270,2305,35,90,10,1,C
202A,202A,15,2341,2407,66,90,10,1,C
202A,202A,15,2547,2567,20,90,10,1,C
202A,202A,15,2612,2623,11,90,10,1,C
202A,202A,15,2693,2749,56,90,10,1,C
202A,202A,15,2827,2852,25,90,10,1,C
202A,202A,15,2927,2958,31,90,10,1,C
202A,202A,15,2967,3000,33,90,10,1,C
202A,202A,28,0,22,22,90,10,1,C
202A,202A,28,58,128,70,90,10,1,C
202A,202A,28,196,218,22,90,10,1,C
202A,202A,28,253,337,84,90,10,1,C
202A,202A,28,356,370,14,90,10,1,C
202A,202A,28,403,425,22,90,10,1,C
202A,202A,28,453,475,22,90,10,1,C
202A,202A,28,490,508,18,90,10,1,C
202A,202A,28,536,565,29,90,10,1,C
202A,202A,28,595,610,15,90,10,1,C
202A,202A,28,637,716,79,90,10,1,C
202A,202A,28,766,786,20,90,10,1,C
202A,202A,28,809,828,19,90,10,1,C
202A,202A,28,863,888,25,90,10,1,C
202A,202A,28,919,946,27,90,10,1,C
202A,202A,28,959,1016,57,90,10,1,C
202A,202A,28,1158,1182,24,90,10,1,C
202A,202A,28,1218,1260,42,90,10,1,C
202A,202A,28,1302,1392,90,90,10,1,C
202A,202A,28,1406,1430,24,90,10,1,C
202A,202A,28,1441,1514,73,90,10,1,C
202A,202A,28,1531,1570,39,90,10,1,C
202A,202A,28,1580,1598,18,90,10,1,C
202A,202A,28,1733,1762,29,90,10,1,C
202A,202A,28,1880,1916,36,90,10,1,C
202A,202A,28,1930,1944,14,90,10,1,C
202A,202A,28,1957,2042,85,90,10,1,C
202A,202A,28,2069,2165,96,90,10,1,C
202A,202A,28,2187,2319,132,90,10,1,C
202A,202A,28,2338,2490,152,90,10,1,C
202A,202A,28,2510,2528,18,90,10,1,C
202A,202A,28,2561,2577,16,90,10,1,C
202A,202A,28,2623,2655,32,90,10,1,C
202A,202A,28,2678,2740,62,90,10,1,C
202A,202A,28,2773,2819,46,90,10,1,C
202A,202A,28,2843,2871,28,90,10,1,C
202A,202A,28,2920,2970,50,90,10,1,C
202A,202A,28,2990,3000,10,90,10,1,C
202G,202G,2,28,39,11,90,10,1,C
202G,202G,2,75,102,27,90,10,1,C
202G,202G,2,152,185,33,90,10,1,C
202G,202G,2,204,223,19,90,10,1,C
202G,202G,2,260,280,20,90,10,1,C
202G,202G,2,305,320,15,90,10,1,C
202G,202G,2,333,384,51,90,10,1,C
202G,202G,2,417,427,10,90,10,1,C
202G,202G,2,452,470,18,90,10,1,C
202G,202G,2,486,512,26,90,10,1,C
202G,202G,2,523,545,22,90,10,1,C
202G,202G,2,563,589,26,90,10,1,C
202G,202G,2,597,607,10,90,10,1,C
202G,202G,2,632,683,51,90,10,1,C
202G,202G,2,722,740,18,90,10,1,C
202G,202G,2,816,842,26,90,10,1,C
202G,202G,2,879,891,12,90,10,1,C
202G,202G,2,972,1033,61,90,10,1,C
202G,202G,2,1053,1119,66,90,10,1,C
202G,202G,2,1130,1140,10,90,10,1,C
202G,202G,2,1156,1189,33,90,10,1,C
202G,202G,2,1239,1266,27,90,10,1,C
202G,202G,2,1275,1300,25,90,10,1,C
202G,202G,2,1318,1375,57,90,10,1,C
202G,202G,2,1436,1463,27,90,10,1,C
202G,202G,2,1485,1500,15,90,10,1,C
202G,202G,2,1515,1525,10,90,10,1,C
202G,202G,2,1558,1583,25,90,10,1,C
202G,202G,2,1624,1660,36,90,10,1,C
202G,202G,2,1687,1708,21,90,10,1,C
202G,202G,2,1723,1763,40,90,10,1,C
202G,202G,2,1834,1860,26,90,10,1,C
202G,202G,2,1945,1976,31,90,10,1,C
202G,202G,2,1984,1995,11,90,10,1,C
202G,202G,2,2059,2100,41,90,10,1,C
202G,202G,2,2120,2223,103,90,10,1,C
202G,202G,2,2250,2280,30,90,10,1,C
202G,202G,2,2305,2317,12,90,10,1,C
202G,202G,2,2355,2379,24,90,10,1,C
202G,202G,2,2411,2455,44,90,10,1,C
202G,202G,2,2494,2518,24,90,10,1,C
202G,202G,2,2563,2617,54,90,10,1,C
202G,202G,2,2642,2658,16,90,10,1,C
202G,202G,2,2666,2676,10,90,10,1,C
202G,202G,2,2690,2735,45,90,10,1,C
202G,202G,2,2762,2780,18,90,10,1,C
202G,202G,2,2803,2818,15,90,10,1,C
202G,202G,2,2891,2923,32,90,10,1,C
202G,202G,2,2949,2983,34,90,10,1,C
202G,202G,15,46,56,10,90,10,1,C
202G,202G,15,94,104,10,90,10,1,C
202G,202G,15,114,128,14,90,10,1,C
202G,202G,15,134,145,11,90,10,1,C
202G,202G,15,172,189,17,90,10,1,C
202G,202G,15,225,242,17,90,10,1,C
202G,202G,15,253,264,11,90,10,1,C
202G,202G,15,279,297,18,90,10,1,C
202G,202G,15,310,340,30,90,10,1,C
202G,202G,15,449,565,116,90,10,1,C
202G,202G,15,605,628,23,90,10,1,C
202G,202G,15,660,703,43,90,10,1,C
202G,202G,15,770,780,10,90,10,1,C
202G,202G,15,798,826,28,90,10,1,C
202G,202G,15,867,888,21,90,10,1,C
202G,202G,15,902,926,24,90,10,1,C
202G,202G,15,960,970,10,90,10,1,C
202G,202G,15,998,1030,32,90,10,1,C
202G,202G,15,1047,1090,43,90,10,1,C
202G,202G,15,1101,1119,18,90,10,1,C
202G,202G,15,1143,1163,20,90,10,1,C
202G,202G,15,1328,1342,14,90,10,1,C
202G,202G,15,1449,1462,13,90,10,1,C
202G,202G,15,1509,1532,23,90,10,1,C
202G,202G,15,1546,1622,76,90,10,1,C
202G,202G,15,1643,1676,33,90,10,1,C
202G,202G,15,1701,1711,10,90,10,1,C
202G,202G,15,1718,1746,28,90,10,1,C
202G,202G,15,1782,1811,29,90,10,1,C
202G,202G,15,1880,1896,16,90,10,1,C
202G,202G,15,1919,1934,15,90,10,1,C
202G,202G,15,1945,1983,38,90,10,1,C
202G,202G,15,1995,2005,10,90,10,1,C
202G,202G,15,2095,2107,12,90,10,1,C
202G,202G,15,2115,2145,30,90,10,1,C
202G,202G,15,2167,2187,20,90,10,1,C
202G,202G,15,2220,2240,20,90,10,1,C
202G,202G,15,2248,2274,26,90,10,1,C
202G,202G,15,2315,2335,20,90,10,1,C
202G,202G,15,2345,2395,50,90,10,1,C
202G,202G,15,2412,2437,25,90,10,1,C
202G,202G,15,2452,2462,10,90,10,1,C
202G,202G,15,2490,2500,10,90,10,1,C
202G,202G,15,2522,2560,38,90,10,1,C
202G,202G,15,2586,2613,27,90,10,1,C
202G,202G,15,2642,2660,18,90,10,1,C
202G,202G,15,2678,2694,16,90,10,1,C
202G,202G,15,2762,2782,20,90,10,1,C
202G,202G,15,2937,2970,33,90,10,1,C
202G,202G,28,17,56,39,90,10,1,C
202G,202G,28,69,82,13,90,10,1,C
202G,202G,28,120,149,29,90,10,1,C
202G,202G,28,206,216,10,90,10,1,C
202G,202G,28,229,239,10,90,10,1,C
202G,202G,28,255,275,20,90,10,1,C
202G,202G,28,385,399,14,90,10,1,C
202G,202G,28,506,518,12,90,10,1,C
202G,202G,28,590,607,17,90,10,1,C
202G,202G,28,660,670,10,90,10,1,C
202G,202G,28,843,859,16,90,10,1,C
202G,202G,28,890,900,10,90,10,1,C
202G,202G,28,940,996,56,90,10,1,C
202G,202G,28,1036,1068,32,90,10,1,C
202G,202G,28,1079,1092,13,90,10,1,C
202G,202G,28,1150,1171,21,90,10,1,C
202G,202G,28,1227,1241,14,90,10,1,C
202G,202G,28,1259,1274,15,90,10,1,C
202G,202G,28,1301,1330,29,90,10,1,C
202G,202G,28,1356,1400,44,90,10,1,C
202G,202G,28,1430,1448,18,90,10,1,C
202G,202G,28,1455,1478,23,90,10,1,C
202G,202G,28,1503,1523,20,90,10,1,C
202G,202G,28,1550,1573,23,90,10,1,C
202G,202G,28,1605,1616,11,90,10,1,C
202G,202G,28,1636,1653,17,90,10,1,C
202G,202G,28,1670,1680,10,90,10,1,C
202G,202G,28,1715,1725,10,90,10,1,C
202G,202G,28,1759,1816,57,90,10,1,C
202G,202G,28,1837,1853,16,90,10,1,C
202G,202G,28,1876,1894,18,90,10,1,C
202G,202G,28,1930,1952,22,90,10,1,C
202G,202G,28,1963,2043,80,90,10,1,C
202G,202G,28,2097,2137,40,90,10,1,C
202G,202G,28,2151,2190,39,90,10,1,C
202G,202G,28,2255,2275,20,90,10,1,C
202G,202G,28,2323,2352,29,90,10,1,C
202G,202G,28,2394,2414,20,90,10,1,C
202G,202G,28,2424,2450,26,90,10,1,C
202G,202G,28,2457,2488,31,90,10,1,C
202G,202G,28,2506,2637,131,90,10,1,C
202G,202G,28,2717,2805,88,90,10,1,C
202G,202G,28,2825,2894,69,90,10,1,C
202G,202G,28,2905,2988,83,90,10,1,C
203A,203A,2,5,25,20,90,10,1,C
203A,203A,2,40,58,18,90,10,1,C
203A,203A,2,63,77,14,90,10,1,C
203A,203A,2,119,160,41,90,10,1,C
203A,203A,2,170,181,11,90,10,1,C
203A,203A,2,270,324,54,90,10,1,C
203A,203A,2,415,426,11,90,10,1,C
203A,203A,2,862,880,18,90,10,1,C
203A,203A,2,887,931,44,90,10,1,C
203A,203A,2,959,978,19,90,10,1,C
203A,203A,2,984,1000,16,90,10,1,C
203A,203A,2,1018,1049,31,90,10,1,C
203A,203A,2,1056,1068,12,90,10,1,C
203A,203A,2,1089,1104,15,90,10,1,C
203A,203A,2,1146,1166,20,90,10,1,C
203A,203A,2,1230,1245,15,90,10,1,C
203A,203A,2,1330,1353,23,90,10,1,C
203A,203A,2,1440,1460,20,90,10,1,C
203A,203A,2,1683,1703,20,90,10,1,C
203A,203A,2,1717,1748,31,90,10,1,C
203A,203A,2,1835,1845,10,90,10,1,C
203A,203A,2,1872,1882,10,90,10,1,C
203A,203A,2,1936,1956,20,90,10,1,C
203A,203A,2,1985,2013,28,90,10,1,C
203A,203A,2,2019,2031,12,90,10,1,C
203A,203A,2,2046,2094,48,90,10,1,C
203A,203A,2,2241,2262,21,90,10,1,C
203A,203A,2,2292,2355,63,90,10,1,C
203A,203A,2,2538,2670,132,90,10,1,C
203A,203A,2,2638,2656,18,90,10,1,C
203A,203A,15,0,111,111,90,10,1,C
203A,203A,15,116,132,16,90,10,1,C
203A,203A,15,146,234,88,90,10,1,C
203A,203A,15,248,273,25,90,10,1,C
203A,203A,15,315,338,23,90,10,1,C
203A,203A,15,433,487,54,90,10,1,C
203A,203A,15,552,593,41,90,10,1,C
203A,203A,15,643,693,50,90,10,1,C
203A,203A,15,735,787,52,90,10,1,C
203A,203A,15,803,828,25,90,10,1,C
203A,203A,15,837,854,17,90,10,1,C
203A,203A,15,893,915,22,90,10,1,C
203A,203A,15,937,965,28,90,10,1,C
203A,203A,15,995,1010,15,90,10,1,C
203A,203A,15,1083,1094,11,90,10,1,C
203A,203A,15,1134,1148,14,90,10,1,C
203A,203A,15,1160,1172,12,90,10,1,C
203A,203A,15,1249,1269,20,90,10,1,C
203A,203A,15,1358,1376,18,90,10,1,C
203A,203A,15,1415,1439,24,90,10,1,C
203A,203A,15,1474,1488,14,90,10,1,C
203A,203A,15,1496,1522,26,90,10,1,C
203A,203A,15,1562,1584,22,90,10,1,C
203A,203A,15,1613,1642,29,90,10,1,C
203A,203A,15,1648,1671,23,90,10,1,C
203A,203A,15,1681,1723,42,90,10,1,C
203A,203A,15,1779,1825,46,90,10,1,C
203A,203A,15,1877,1892,15,90,10,1,C
203A,203A,15,1911,1959,48,90,10,1,C
203A,203A,15,1976,1991,15,90,10,1,C
203A,203A,15,2009,2051,42,90,10,1,C
203A,203A,15,2063,2099,36,90,10,1,C
203A,203A,15,2108,2208,100,90,10,1,C
203A,203A,15,2238,2281,43,90,10,1,C
203A,203A,15,2312,2357,45,90,10,1,C
203A,203A,15,2378,2420,42,90,10,1,C
203A,203A,15,2430,2445,15,90,10,1,C
203A,203A,15,2501,2522,21,90,10,1,C
203A,203A,15,2572,2587,15,90,10,1,C
203A,203A,15,2595,2617,22,90,10,1,C
203A,203A,15,2624,2634,10,90,10,1,C
203A,203A,15,2700,2755,55,90,10,1,C
203A,203A,15,2769,2783,14,90,10,1,C
203A,203A,15,2790,2803,13,90,10,1,C
203A,203A,15,2809,2829,20,90,10,1,C
203A,203A,15,2840,2861,21,90,10,1,C
203A,203A,15,2881,2893,12,90,10,1,C
203A,203A,28,445,467,22,90,10,1,C
203A,203A,28,487,500,13,90,10,1,C
203A,203A,28,579,607,28,90,10,1,C
203A,203A,28,729,749,20,90,10,1,C
203A,203A,28,858,874,16,90,10,1,C
203A,203A,28,985,1005,20,90,10,1,C
203A,203A,28,1010,1025,15,90,10,1,C
203A,203A,28,1297,1319,22,90,10,1,C
203A,203A,28,1454,1478,24,90,10,1,C
203A,203A,28,1536,1552,16,90,10,1,C
203A,203A,28,1669,1684,15,90,10,1,C
203A,203A,28,1747,1759,12,90,10,1,C
203A,203A,28,1765,1777,12,90,10,1,C
203A,203A,28,1863,1908,45,90,10,1,C
203A,203A,28,1929,1963,34,90,10,1,C
203A,203A,28,2281,2315,34,90,10,1,C
203A,203A,28,2330,2357,27,90,10,1,C
203A,203A,28,2378,2414,36,90,10,1,C
203A,203A,28,2657,2675,18,90,10,1,C
203A,203A,28,2697,2707,10,90,10,1,C
203A,203A,28,2777,2789,12,90,10,1,C
203A,203A,28,2884,2914,30,90,10,1,C
203G,203G,2,45,55,10,90,10,1,C
203G,203G,2,76,87,11,90,10,1,C
203G,203G,2,125,136,11,90,10,1,C
203G,203G,2,167,180,13,90,10,1,C
203G,203G,2,192,210,18,90,10,1,C
203G,203G,2,240,250,10,90,10,1,C
203G,203G,2,353,373,20,90,10,1,C
203G,203G,2,419,433,14,90,10,1,C
203G,203G,2,522,540,18,90,10,1,C
203G,203G,2,605,620,15,90,10,1,C
203G,203G,2,627,649,22,90,10,1,C
203G,203G,2,680,690,10,90,10,1,C
203G,203G,2,800,810,10,90,10,1,C
203G,203G,2,830,845,15,90,10,1,C
203G,203G,2,865,890,25,90,10,1,C
203G,203G,2,941,951,10,90,10,1,C
203G,203G,2,1110,1142,32,90,10,1,C
203G,203G,2,1256,1267,11,90,10,1,C
203G,203G,2,1332,1372,40,90,10,1,C
203G,203G,2,1431,1450,19,90,10,1,C
203G,203G,2,1495,1510,15,90,10,1,C
203G,203G,2,1605,1620,15,90,10,1,C
203G,203G,2,1760,1772,12,90,10,1,C
203G,203G,2,1885,1895,10,90,10,1,C
203G,203G,2,1910,1925,15,90,10,1,C
203G,203G,2,1975,1985,10,90,10,1,C
203G,203G,2,2215,2233,18,90,10,1,C
203G,203G,2,2293,2303,10,90,10,1,C
203G,203G,2,2325,2343,18,90,10,1,C
203G,203G,2,2369,2390,21,90,10,1,C
203G,203G,2,2405,2417,12,90,10,1,C
203G,203G,2,2440,2450,10,90,10,1,C
203G,203G,2,2482,2504,22,90,10,1,C
203G,203G,2,2550,2570,20,90,10,1,C
203G,203G,2,2581,2650,69,90,10,1,C
203G,203G,2,2708,2736,28,90,10,1,C
203G,203G,2,2766,2779,13,90,10,1,C
203G,203G,2,2806,2826,20,90,10,1,C
203G,203G,2,2955,2965,10,90,10,1,C
203G,203G,15,0,120,120,90,10,1,C
203G,203G,15,141,162,21,90,10,1,C
203G,203G,15,185,204,19,90,10,1,C
203G,203G,15,326,336,10,90,10,1,C
203G,203G,15,363,375,12,90,10,1,C
203G,203G,15,396,414,18,90,10,1,C
203G,203G,15,421,433,12,90,10,1,C
203G,203G,15,465,503,38,90,10,1,C
203G,203G,15,550,581,31,90,10,1,C
203G,203G,15,590,600,10,90,10,1,C
203G,203G,15,611,629,18,90,10,1,C
203G,203G,15,641,661,20,90,10,1,C
203G,203G,15,705,715,10,90,10,1,C
203G,203G,15,773,788,15,90,10,1,C
203G,203G,15,799,823,24,90,10,1,C
203G,203G,15,885,915,30,90,10,1,C
203G,203G,15,951,964,13,90,10,1,C
203G,203G,15,979,1003,24,90,10,1,C
203G,203G,15,1011,1044,33,90,10,1,C
203G,203G,15,1072,1116,44,90,10,1,C
203G,203G,15,1192,1221,29,90,10,1,C
203G,203G,15,1246,1263,17,90,10,1,C
203G,203G,15,1383,1393,10,90,10,1,C
203G,203G,15,1438,1465,27,90,10,1,C
203G,203G,15,1481,1496,15,90,10,1,C
203G,203G,15,1511,1524,13,90,10,1,C
203G,203G,15,1555,1593,38,90,10,1,C
203G,203G,15,1644,1661,17,90,10,1,C
203G,203G,15,1681,1722,41,90,10,1,C
203G,203G,15,1770,1792,22,90,10,1,C
203G,203G,15,1834,1855,21,90,10,1,C
203G,203G,15,1865,1880,15,90,10,1,C
203G,203G,15,1892,1905,13,90,10,1,C
203G,203G,15,1963,1978,15,90,10,1,C
203G,203G,15,2076,2086,10,90,10,1,C
203G,203G,15,2125,2137,12,90,10,1,C
203G,203G,15,2220,2244,24,90,10,1,C
203G,203G,15,2354,2369,15,90,10,1,C
203G,203G,15,2399,2414,15,90,10,1,C
203G,203G,15,2445,2657,212,90,10,1,C
203G,203G,15,2729,2739,10,90,10,1,C
203G,203G,15,2845,2859,14,90,10,1,C
203G,203G,15,2871,2892,21,90,10,1,C
203G,203G,15,2922,2936,14,90,10,1,C
203G,203G,28,37,65,28,90,10,1,C
203G,203G,28,169,220,51,90,10,1,C
203G,203G,28,300,330,30,90,10,1,C
203G,203G,28,544,556,12,90,10,1,C
203G,203G,28,560,580,20,90,10,1,C
203G,203G,28,690,765,75,90,10,1,C
203G,203G,28,780,791,11,90,10,1,C
203G,203G,28,801,830,29,90,10,1,C
203G,203G,28,911,930,19,90,10,1,C
203G,203G,28,935,951,16,90,10,1,C
203G,203G,28,989,1005,16,90,10,1,C
203G,203G,28,1025,1036,11,90,10,1,C
203G,203G,28,1100,1110,10,90,10,1,C
203G,203G,28,1138,1148,10,90,10,1,C
203G,203G,28,1161,1184,23,90,10,1,C
203G,203G,28,1423,1441,18,90,10,1,C
203G,203G,28,1446,1456,10,90,10,1,C
203G,203G,28,1468,1482,14,90,10,1,C
203G,203G,28,1520,1533,13,90,10,1,C
203G,203G,28,1542,1552,10,90,10,1,C
203G,203G,28,1584,1606,22,90,10,1,C
203G,203G,28,1617,1632,15,90,10,1,C
203G,203G,28,1664,1695,31,90,10,1,C
203G,203G,28,1707,1741,34,90,10,1,C
203G,203G,28,1807,1846,39,90,10,1,C
203G,203G,28,1860,1886,26,90,10,1,C
203G,203G,28,1906,1955,49,90,10,1,C
203G,203G,28,2062,2084,22,90,10,1,C
203G,203G,28,2108,2133,25,90,10,1,C
203G,203G,28,2154,2180,26,90,10,1,C
203G,203G,28,2209,2239,30,90,10,1,C
203G,203G,28,2246,2260,14,90,10,1,C
203G,203G,28,2291,2310,19,90,10,1,C
203G,203G,28,2366,2384,18,90,10,1,C
203G,203G,28,2546,2735,189,90,10,1,C
203G,203G,28,2783,2820,37,90,10,1,C
203G,203G,28,2829,2857,28,90,10,1,C
203G,203G,28,2879,2890,11,90,10,1,C
203G,203G,28,2895,2943,48,90,10,1,C
203G,203G,28,2949,2974,25,90,10,1,C
203G,203G,28,2979,3000,21,90,10,1,C
204A,204A,2,45,102,57,90,10,1,C
204A,204A,2,128,151,23,90,10,1,C
204A,204A,2,186,218,32,90,10,1,C
204A,204A,2,255,320,65,90,10,1,C
204A,204A,2,336,374,38,90,10,1,C
204A,204A,2,380,400,20,90,10,1,C
204A,204A,2,414,435,21,90,10,1,C
204A,204A,2,440,450,10,90,10,1,C
204A,204A,2,578,588,10,90,10,1,C
204A,204A,2,668,698,30,90,10,1,C
204A,204A,2,703,719,16,90,10,1,C
204A,204A,2,764,801,37,90,10,1,C
204A,204A,2,850,864,14,90,10,1,C
204A,204A,2,871,936,65,90,10,1,C
204A,204A,2,953,970,17,90,10,1,C
204A,204A,2,992,1020,28,90,10,1,C
204A,204A,2,1058,1076,18,90,10,1,C
204A,204A,2,1085,1150,65,90,10,1,C
204A,204A,2,1185,1245,60,90,10,1,C
204A,204A,2,1400,1411,11,90,10,1,C
204A,204A,2,1436,1447,11,90,10,1,C
204A,204A,2,1457,1486,29,90,10,1,C
204A,204A,2,1491,1512,21,90,10,1,C
204A,204A,2,1518,1528,10,90,10,1,C
204A,204A,2,1542,1564,22,90,10,1,C
204A,204A,2,1569,1590,21,90,10,1,C
204A,204A,2,1632,1675,43,90,10,1,C
204A,204A,2,1699,1718,19,90,10,1,C
204A,204A,2,1782,1842,60,90,10,1,C
204A,204A,2,2130,2148,18,90,10,1,C
204A,204A,2,2170,2191,21,90,10,1,C
204A,204A,2,2205,2223,18,90,10,1,C
204A,204A,2,2271,2403,132,90,10,1,C
204A,204A,2,2478,2507,29,90,10,1,C
204A,204A,2,2566,2608,42,90,10,1,C
204A,204A,2,2620,2696,76,90,10,1,C
204A,204A,2,2704,2729,25,90,10,1,C
204A,204A,2,2736,2754,18,90,10,1,C
204A,204A,2,2761,2772,11,90,10,1,C
204A,204A,2,2810,2820,10,90,10,1,C
204A,204A,2,2854,2882,28,90,10,1,C
204A,204A,15,172,195,23,90,10,1,C
204A,204A,15,240,282,42,90,10,1,C
204A,204A,15,291,304,13,90,10,1,C
204A,204A,15,340,360,20,90,10,1,C
204A,204A,15,368,378,10,90,10,1,C
204A,204A,15,400,443,43,90,10,1,C
204A,204A,15,530,575,45,90,10,1,C
204A,204A,15,632,645,13,90,10,1,C
204A,204A,15,725,757,32,90,10,1,C
204A,204A,15,806,823,17,90,10,1,C
204A,204A,15,850,874,24,90,10,1,C
204A,204A,15,935,961,26,90,10,1,C
204A,204A,15,984,1008,24,90,10,1,C
204A,204A,15,1034,1100,66,90,10,1,C
204A,204A,15,1105,1200,95,90,10,1,C
204A,204A,15,1207,1222,15,90,10,1,C
204A,204A,15,1230,1253,23,90,10,1,C
204A,204A,15,1282,1301,19,90,10,1,C
204A,204A,15,1456,1471,15,90,10,1,C
204A,204A,15,1487,1567,80,90,10,1,C
204A,204A,15,1578,1656,78,90,10,1,C
204A,204A,15,1667,1680,13,90,10,1,C
204A,204A,15,1692,1713,21,90,10,1,C
204A,204A,15,1726,1741,15,90,10,1,C
204A,204A,15,1872,1888,16,90,10,1,C
204A,204A,15,1982,2000,18,90,10,1,C
204A,204A,15,2019,2029,10,90,10,1,C
204A,204A,15,2090,2101,11,90,10,1,C
204A,204A,15,2113,2132,19,90,10,1,C
204A,204A,15,2275,2305,30,90,10,1,C
204A,204A,15,2319,2339,20,90,10,1,C
204A,204A,15,2363,2423,60,90,10,1,C
204A,204A,15,2440,2485,45,90,10,1,C
204A,204A,15,2658,2690,32,90,10,1,C
204A,204A,15,2722,2752,30,90,10,1,C
204A,204A,15,2770,2793,23,90,10,1,C
204A,204A,15,2798,2888,90,90,10,1,C
204A,204A,15,2896,2970,74,90,10,1,C
204A,204A,15,2978,3000,22,90,10,1,C
204A,204A,28,604,637,33,90,10,1,C
204A,204A,28,652,672,20,90,10,1,C
204A,204A,28,718,738,20,90,10,1,C
204A,204A,28,884,922,38,90,10,1,C
204A,204A,28,1694,1720,26,90,10,1,C
204A,204A,28,1725,1752,27,90,10,1,C
204A,204A,28,1784,1804,20,90,10,1,C
204A,204A,28,1811,1829,18,90,10,1,C
204A,204A,28,1837,1880,43,90,10,1,C
204A,204A,28,1896,1920,24,90,10,1,C
204A,204A,28,1936,1976,40,90,10,1,C
204A,204A,28,2222,2253,31,90,10,1,C
204A,204A,28,2279,2341,62,90,10,1,C
204A,204A,28,2355,2376,21,90,10,1,C
204A,204A,28,2448,2479,31,90,10,1,C
204A,204A,28,2501,2529,28,90,10,1,C
204A,204A,28,2544,2596,52,90,10,1,C
204A,204A,28,2602,2650,48,90,10,1,C
204A,204A,28,2672,2683,11,90,10,1,C
204G,204G,2,97,111,14,90,10,1,C
204G,204G,2,159,174,15,90,10,1,C
204G,204G,2,257,271,14,90,10,1,C
204G,204G,2,420,442,22,90,10,1,C
204G,204G,2,553,565,12,90,10,1,C
204G,204G,2,575,594,19,90,10,1,C
204G,204G,2,627,663,36,90,10,1,C
204G,204G,2,682,709,27,90,10,1,C
204G,204G,2,768,785,17,90,10,1,C
204G,204G,2,790,817,27,90,10,1,C
204G,204G,2,822,844,22,90,10,1,C
204G,204G,2,854,892,38,90,10,1,C
204G,204G,2,959,986,27,90,10,1,C
204G,204G,2,1047,1065,18,90,10,1,C
204G,204G,2,1075,1096,21,90,10,1,C
204G,204G,2,1120,1133,13,90,10,1,C
204G,204G,2,1150,1160,10,90,10,1,C
204G,204G,2,1205,1232,27,90,10,1,C
204G,204G,2,1240,1261,21,90,10,1,C
204G,204G,2,1271,1316,45,90,10,1,C
204G,204G,2,1327,1343,16,90,10,1,C
204G,204G,2,1349,1360,11,90,10,1,C
204G,204G,2,1388,1400,12,90,10,1,C
204G,204G,2,1415,1436,21,90,10,1,C
204G,204G,2,1441,1466,25,90,10,1,C
204G,204G,2,1492,1537,45,90,10,1,C
204G,204G,2,1564,1589,25,90,10,1,C
204G,204G,2,1612,1644,32,90,10,1,C
204G,204G,2,1659,1678,19,90,10,1,C
204G,204G,2,1720,1739,19,90,10,1,C
204G,204G,2,1761,1804,43,90,10,1,C
204G,204G,2,1915,1941,26,90,10,1,C
204G,204G,2,1949,1959,10,90,10,1,C
204G,204G,2,1964,1974,10,90,10,1,C
204G,204G,2,1983,1997,14,90,10,1,C
204G,204G,2,2005,2032,27,90,10,1,C
204G,204G,2,2061,2082,21,90,10,1,C
204G,204G,2,2088,2102,14,90,10,1,C
204G,204G,2,2185,2197,12,90,10,1,C
204G,204G,2,2287,2299,12,90,10,1,C
204G,204G,2,2319,2338,19,90,10,1,C
204G,204G,2,2347,2365,18,90,10,1,C
204G,204G,2,2382,2430,48,90,10,1,C
204G,204G,2,2436,2513,77,90,10,1,C
204G,204G,2,2543,2569,26,90,10,1,C
204G,204G,2,2587,2618,31,90,10,1,C
204G,204G,2,2635,2650,15,90,10,1,C
204G,204G,2,2762,2785,23,90,10,1,C
204G,204G,2,2888,2916,28,90,10,1,C
204G,204G,15,0,26,26,90,10,1,C
204G,204G,15,39,68,29,90,10,1,C
204G,204G,15,89,102,13,90,10,1,C
204G,204G,15,112,124,12,90,10,1,C
204G,204G,15,161,200,39,90,10,1,C
204G,204G,15,208,231,23,90,10,1,C
204G,204G,15,240,286,46,90,10,1,C
204G,204G,15,302,343,41,90,10,1,C
204G,204G,15,391,409,18,90,10,1,C
204G,204G,15,433,449,16,90,10,1,C
204G,204G,15,457,476,19,90,10,1,C
204G,204G,15,506,516,10,90,10,1,C
204G,204G,15,600,637,37,90,10,1,C
204G,204G,15,710,726,16,90,10,1,C
204G,204G,15,749,776,27,90,10,1,C
204G,204G,15,783,849,66,90,10,1,C
204G,204G,15,873,928,55,90,10,1,C
204G,204G,15,968,1005,37,90,10,1,C
204G,204G,15,1029,1066,37,90,10,1,C
204G,204G,15,1084,1100,16,90,10,1,C
204G,204G,15,1112,1169,57,90,10,1,C
204G,204G,15,1174,1243,69,90,10,1,C
204G,204G,15,1306,1316,10,90,10,1,C
204G,204G,15,1328,1359,31,90,10,1,C
204G,204G,15,1402,1449,47,90,10,1,C
204G,204G,15,1482,1497,15,90,10,1,C
204G,204G,15,1801,1815,14,90,10,1,C
204G,204G,15,1823,1850,27,90,10,1,C
204G,204G,15,1869,1890,21,90,10,1,C
204G,204G,15,1900,1911,11,90,10,1,C
204G,204G,15,1916,1932,16,90,10,1,C
204G,204G,15,1936,1969,33,90,10,1,C
204G,204G,15,1976,1996,20,90,10,1,C
204G,204G,15,2014,2046,32,90,10,1,C
204G,204G,15,2057,2093,36,90,10,1,C
204G,204G,15,2099,2135,36,90,10,1,C
204G,204G,15,2147,2161,14,90,10,1,C
204G,204G,15,2214,2276,62,90,10,1,C
204G,204G,15,2296,2351,55,90,10,1,C
204G,204G,15,2368,2389,21,90,10,1,C
204G,204G,15,2394,2438,44,90,10,1,C
204G,204G,15,2459,2477,18,90,10,1,C
204G,204G,15,2530,2558,28,90,10,1,C
204G,204G,15,2570,2595,25,90,10,1,C
204G,204G,15,2621,2646,25,90,10,1,C
204G,204G,15,2654,2685,31,90,10,1,C
204G,204G,15,2693,2727,34,90,10,1,C
204G,204G,15,2731,2744,13,90,10,1,C
204G,204G,15,2760,2773,13,90,10,1,C
204G,204G,15,2780,2802,22,90,10,1,C
204G,204G,15,2811,2892,81,90,10,1,C
204G,204G,15,2908,2926,18,90,10,1,C
204G,204G,15,2931,2949,18,90,10,1,C
204G,204G,15,2970,2992,22,90,10,1,C
204G,204G,28,21,159,138,90,10,1,C
204G,204G,28,175,220,45,90,10,1,C
204G,204G,28,409,429,20,90,10,1,C
204G,204G,28,490,510,20,90,10,1,C
204G,204G,28,581,615,34,90,10,1,C
204G,204G,28,670,688,18,90,10,1,C
204G,204G,28,751,765,14,90,10,1,C
204G,204G,28,782,813,31,90,10,1,C
204G,204G,28,906,939,33,90,10,1,C
204G,204G,28,965,1097,132,90,10,1,C
204G,204G,28,1137,1162,25,90,10,1,C
204G,204G,28,1189,1221,32,90,10,1,C
204G,204G,28,1244,1310,66,90,10,1,C
204G,204G,28,1319,1351,32,90,10,1,C
204G,204G,28,1361,1464,103,90,10,1,C
204G,204G,28,1583,1595,12,90,10,1,C
204G,204G,28,1704,1719,15,90,10,1,C
204G,204G,28,1784,1802,18,90,10,1,C
204G,204G,28,1839,1864,25,90,10,1,C
204G,204G,28,1872,1892,20,90,10,1,C
204G,204G,28,1920,1948,28,90,10,1,C
204G,204G,28,1956,1972,16,90,10,1,C
204G,204G,28,2005,2022,17,90,10,1,C
204G,204G,28,2105,2121,16,90,10,1,C
204G,204G,28,2211,2227,16,90,10,1,C
204G,204G,28,2255,2273,18,90,10,1,C
204G,204G,28,2321,2360,39,90,10,1,C
204G,204G,28,2365,2385,20,90,10,1,C
204G,204G,28,2408,2442,34,90,10,1,C
204G,204G,28,2537,2594,57,90,10,1,C
204G,204G,28,2602,2614,12,90,10,1,C
204G,204G,28,2653,2689,36,90,10,1,C
204G,204G,28,2696,2715,19,90,10,1,C
204G,204G,28,2745,2781,36,90,10,1,C
204G,204G,28,2791,2811,20,90,10,1,C
204G,204G,28,2900,2927,27,90,10,1,C
204G,204G,28,2980,2991,11,90,10,1,C
205A,205A,2,25,38,13,90,10,1,C
205A,205A,2,44,83,39,90,10,1,C
205A,205A,2,111,179,68,90,10,1,C
205A,205A,2,208,218,10,90,10,1,C
205A,205A,2,285,325,40,90,10,1,C
205A,205A,2,353,382,29,90,10,1,C
205A,205A,2,411,474,63,90,10,1,C
205A,205A,2,500,520,20,90,10,1,C
205A,205A,2,569,630,61,90,10,1,C
205A,205A,2,690,700,10,90,10,1,C
205A,205A,2,792,813,21,90,10,1,C
205A,205A,2,855,870,15,90,10,1,C
205A,205A,2,875,903,28,90,10,1,C
205A,205A,2,1053,1066,13,90,10,1,C
205A,205A,2,1088,1139,51,90,10,1,C
205A,205A,2,1149,1162,13,90,10,1,C
205A,205A,2,1183,1193,10,90,10,1,C
205A,205A,2,1216,1228,12,90,10,1,C
205A,205A,2,1235,1245,10,90,10,1,C
205A,205A,2,1343,1368,25,90,10,1,C
205A,205A,2,1399,1411,12,90,10,1,C
205A,205A,2,1433,1465,32,90,10,1,C
205A,205A,2,1508,1531,23,90,10,1,C
205A,205A,2,1547,1656,109,90,10,1,C
205A,205A,2,1671,1751,80,90,10,1,C
205A,205A,2,1762,1785,23,90,10,1,C
205A,205A,2,1795,1817,22,90,10,1,C
205A,205A,2,1859,1870,11,90,10,1,C
205A,205A,2,1880,1908,28,90,10,1,C
205A,205A,2,1913,1950,37,90,10,1,C
205A,205A,2,1996,2037,41,90,10,1,C
205A,205A,2,2053,2070,17,90,10,1,C
205A,205A,2,2095,2117,22,90,10,1,C
205A,205A,2,2125,2201,76,90,10,1,C
205A,205A,2,2250,2264,14,90,10,1,C
205A,205A,2,2301,2321,20,90,10,1,C
205A,205A,2,2402,2492,90,90,10,1,C
205A,205A,2,2521,2533,12,90,10,1,C
205A,205A,2,2623,2645,22,90,10,1,C
205A,205A,2,2680,2702,22,90,10,1,C
205A,205A,2,2717,2751,34,90,10,1,C
205A,205A,2,2790,2804,14,90,10,1,C
205A,205A,2,2823,2857,34,90,10,1,C
205A,205A,2,2886,2931,45,90,10,1,C
205A,205A,2,2965,2981,16,90,10,1,C
205A,205A,15,58,83,25,90,10,1,C
205A,205A,15,88,113,25,90,10,1,C
205A,205A,15,198,228,30,90,10,1,C
205A,205A,15,358,373,15,90,10,1,C
205A,205A,15,420,441,21,90,10,1,C
205A,205A,15,447,524,77,90,10,1,C
205A,205A,15,559,674,115,90,10,1,C
205A,205A,15,700,737,37,90,10,1,C
205A,205A,15,757,810,53,90,10,1,C
205A,205A,15,843,880,37,90,10,1,C
205A,205A,15,888,904,16,90,10,1,C
205A,205A,15,967,1035,68,90,10,1,C
205A,205A,15,1072,1129,57,90,10,1,C
205A,205A,15,1146,1170,24,90,10,1,C
205A,205A,15,1184,1274,90,90,10,1,C
205A,205A,15,1300,1332,32,90,10,1,C
205A,205A,15,1369,1397,28,90,10,1,C
205A,205A,15,1404,1430,26,90,10,1,C
205A,205A,15,1454,1469,15,90,10,1,C
205A,205A,15,1475,1490,15,90,10,1,C
205A,205A,15,1499,1538,39,90,10,1,C
205A,205A,15,1546,1616,70,90,10,1,C
205A,205A,15,1682,1700,18,90,10,1,C
205A,205A,15,1739,1750,11,90,10,1,C
205A,205A,15,1760,1773,13,90,10,1,C
205A,205A,15,1798,1818,20,90,10,1,C
205A,205A,15,1856,1914,58,90,10,1,C
205A,205A,15,1931,1967,36,90,10,1,C
205A,205A,15,1990,2026,36,90,10,1,C
205A,205A,15,2046,2150,104,90,10,1,C
205A,205A,15,2213,2247,34,90,10,1,C
205A,205A,15,2255,2318,63,90,10,1,C
205A,205A,15,2329,2444,115,90,10,1,C
205A,205A,15,2580,2603,23,90,10,1,C
205A,205A,15,2630,2755,125,90,10,1,C
205A,205A,15,2787,2820,33,90,10,1,C
205A,205A,15,2828,2848,20,90,10,1,C
205A,205A,15,2948,2977,29,90,10,1,C
205A,205A,28,0,17,17,90,10,1,C
205A,205A,28,55,72,17,90,10,1,C
205A,205A,28,77,105,28,90,10,1,C
205A,205A,28,116,126,10,90,10,1,C
205A,205A,28,211,258,47,90,10,1,C
205A,205A,28,287,300,13,90,10,1,C
205A,205A,28,306,319,13,90,10,1,C
205A,205A,28,335,345,10,90,10,1,C
205A,205A,28,355,383,28,90,10,1,C
205A,205A,28,442,475,33,90,10,1,C
205A,205A,28,556,605,49,90,10,1,C
205A,205A,28,652,666,14,90,10,1,C
205A,205A,28,682,697,15,90,10,1,C
205A,205A,28,740,769,29,90,10,1,C
205A,205A,28,885,896,11,90,10,1,C
205A,205A,28,915,944,29,90,10,1,C
205A,205A,28,1014,1026,12,90,10,1,C
205A,205A,28,1038,1072,34,90,10,1,C
205A,205A,28,1116,1134,18,90,10,1,C
205A,205A,28,1144,1157,13,90,10,1,C
205A,205A,28,1170,1237,67,90,10,1,C
205A,205A,28,1307,1327,20,90,10,1,C
205A,205A,28,1333,1351,18,90,10,1,C
205A,205A,28,1365,1394,29,90,10,1,C
205A,205A,28,1457,1480,23,90,10,1,C
205A,205A,28,1531,1566,35,90,10,1,C
205A,205A,28,1588,1614,26,90,10,1,C
205A,205A,28,1632,1651,19,90,10,1,C
205A,205A,28,1875,1920,45,90,10,1,C
205A,205A,28,1958,2011,53,90,10,1,C
205A,205A,28,2090,2112,22,90,10,1,C
205A,205A,28,2129,2152,23,90,10,1,C
205A,205A,28,2165,2238,73,90,10,1,C
205A,205A,28,2245,2255,10,90,10,1,C
205A,205A,28,2323,2333,10,90,10,1,C
205A,205A,28,2431,2473,42,90,10,1,C
205A,205A,28,2510,2530,20,90,10,1,C
205A,205A,28,2570,2595,25,90,10,1,C
205A,205A,28,2643,2682,39,90,10,1,C
205A,205A,28,2799,2852,53,90,10,1,C
205A,205A,28,2861,2887,26,90,10,1,C
205A,205A,28,2924,2938,14,90,10,1,C
205A,205A,28,2960,2987,27,90,10,1,C
205G,205G,2,40,115,75,90,10,1,C
205G,205G,2,133,154,21,90,10,1,C
205G,205G,2,168,237,69,90,10,1,C
205G,205G,2,1084,1103,19,90,10,1,C
205G,205G,2,2333,2357,24,90,10,1,C
205G,205G,2,2957,2987,30,90,10,1,C
205G,205G,15,227,303,76,90,10,1,C
205G,205G,15,858,872,14,90,10,1,C
205G,205G,15,1012,1030,18,90,10,1,C
205G,205G,15,1054,1068,14,90,10,1,C
205G,205G,15,1076,1089,13,90,10,1,C
205G,205G,15,1604,1622,18,90,10,1,C
205G,205G,15,1775,1791,16,90,10,1,C
205G,205G,15,2133,2141,8,90,10,1,C
205G,205G,15,2395,2413,18,90,10,1,C
205G,205G,15,2425,2437,12,90,10,1,C
205G,205G,15,2449,2465,16,90,10,1,C
205G,205G,28,23,39,16,90,10,1,C
205G,205G,28,100,120,20,90,10,1,C
205G,205G,28,578,648,70,90,10,1,C
205G,205G,28,750,767,17,90,10,1,C
205G,205G,28,952,964,12,90,10,1,C
205G,205G,28,1648,1663,15,90,10,1,C
205G,205G,28,1965,1993,28,90,10,1,C
205G,205G,28,2083,2100,17,90,10,1,C
205G,205G,28,2205,2230,25,90,10,1,C
205G,205G,28,2236,2268,32,90,10,1,C
205G,205G,28,2282,2314,32,90,10,1,C
205G,205G,28,2340,2365,25,90,10,1,C
205G,205G,28,2431,2462,31,90,10,1,C
205G,205G,28,2588,2608,20,90,10,1,C
205G,205G,28,2827,2922,95,90,10,1,C
205G,205G,28,2862,2873,11,90,10,1,C
206A,206A,2,0,125,125,90,10,1,C
206A,206A,2,180,225,45,90,10,1,C
206A,206A,2,290,310,20,90,10,1,C
206A,206A,2,439,505,66,90,10,1,C
206A,206A,2,575,600,25,90,10,1,C
206A,206A,2,714,730,16,90,10,1,C
206A,206A,2,762,790,28,90,10,1,C
206A,206A,2,938,967,29,90,10,1,C
206A,206A,2,1007,1031,24,90,10,1,C
206A,206A,2,1270,1298,28,90,10,1,C
206A,206A,2,1331,1396,65,90,10,1,C
206A,206A,2,1440,1465,25,90,10,1,C
206A,206A,2,1667,1717,50,90,10,1,C
206A,206A,2,2040,2079,39,90,10,1,C
206A,206A,2,2157,2348,191,90,10,1,C
206A,206A,2,2470,2501,31,90,10,1,C
206A,206A,2,2543,2604,61,90,10,1,C
206A,206A,2,2620,2658,38,90,10,1,C
206A,206A,2,2731,2745,14,90,10,1,C
206A,206A,2,2890,2921,31,90,10,1,C
206A,206A,15,116,163,47,90,10,1,C
206A,206A,15,225,257,32,90,10,1,C
206A,206A,15,320,353,33,90,10,1,C
206A,206A,15,366,585,219,90,10,1,C
206A,206A,15,706,782,76,90,10,1,C
206A,206A,15,854,911,57,90,10,1,C
206A,206A,15,1090,1122,32,90,10,1,C
206A,206A,15,1218,1258,40,90,10,1,C
206A,206A,15,1339,1355,16,90,10,1,C
206A,206A,15,1369,1493,124,90,10,1,C
206A,206A,15,1581,1594,13,90,10,1,C
206A,206A,15,1761,1798,37,90,10,1,C
206A,206A,15,1902,1950,48,90,10,1,C
206A,206A,15,2040,2065,25,90,10,1,C
206A,206A,15,2091,2120,29,90,10,1,C
206A,206A,15,2254,2272,18,90,10,1,C
206A,206A,15,2345,2382,37,90,10,1,C
206A,206A,15,2451,2485,34,90,10,1,C
206A,206A,15,2579,2599,20,90,10,1,C
206A,206A,15,2619,2640,21,90,10,1,C
206A,206A,15,2703,2743,40,90,10,1,C
206A,206A,15,2760,2775,15,90,10,1,C
206A,206A,15,2877,2893,16,90,10,1,C
206A,206A,15,2923,2951,28,90,10,1,C
206A,206A,28,0,35,35,90,10,1,C
206A,206A,28,59,84,25,90,10,1,C
206A,206A,28,278,310,32,90,10,1,C
206A,206A,28,500,541,41,90,10,1,C
206A,206A,28,658,670,12,90,10,1,C
206A,206A,28,789,820,31,90,10,1,C
206A,206A,28,843,863,20,90,10,1,C
206A,206A,28,871,902,31,90,10,1,C
206A,206A,28,963,981,18,90,10,1,C
206A,206A,28,989,1016,27,90,10,1,C
206A,206A,28,1300,1338,38,90,10,1,C
206A,206A,28,1561,1670,109,90,10,1,C
206A,206A,28,1705,1751,46,90,10,1,C
206A,206A,28,1785,1845,60,90,10,1,C
206A,206A,28,1920,1935,15,90,10,1,C
206A,206A,28,2000,2116,116,90,10,1,C
206A,206A,28,2171,2221,50,90,10,1,C
206A,206A,28,2249,2300,51,90,10,1,C
206A,206A,28,2366,2395,29,90,10,1,C
206A,206A,28,2643,2750,107,90,10,1,C
206A,206A,28,2812,2851,39,90,10,1,C
206A,206A,28,2880,2938,58,90,10,1,C
206A,206A,28,2961,3000,39,90,10,1,C
206G,206G,2,165,215,50,90,10,1,C
206G,206G,2,238,269,31,90,10,1,C
206G,206G,2,278,300,22,90,10,1,C
206G,206G,2,350,361,11,90,10,1,C
206G,206G,2,396,418,22,90,10,1,C
206G,206G,2,639,682,43,90,10,1,C
206G,206G,2,720,736,16,90,10,1,C
206G,206G,2,796,817,21,90,10,1,C
206G,206G,2,907,932,25,90,10,1,C
206G,206G,2,1039,1080,41,90,10,1,C
206G,206G,2,1155,1168,13,90,10,1,C
206G,206G,2,1179,1191,12,90,10,1,C
206G,206G,2,1450,1482,32,90,10,1,C
206G,206G,2,1499,1517,18,90,10,1,C
206G,206G,2,1672,1685,13,90,10,1,C
206G,206G,2,1838,1863,25,90,10,1,C
206G,206G,2,1900,1914,14,90,10,1,C
206G,206G,2,1925,1946,21,90,10,1,C
206G,206G,2,1985,2014,29,90,10,1,C
206G,206G,2,2268,2282,14,90,10,1,C
206G,206G,2,2325,2360,35,90,10,1,C
206G,206G,2,2370,2400,30,90,10,1,C
206G,206G,2,2440,2511,71,90,10,1,C
206G,206G,2,2640,2780,140,90,10,1,C
206G,206G,2,2875,2905,30,90,10,1,C
206G,206G,2,2985,3000,15,90,10,1,C
206G,206G,15,125,141,16,90,10,1,C
206G,206G,15,153,216,63,90,10,1,C
206G,206G,15,345,380,35,90,10,1,C
206G,206G,15,402,418,16,90,10,1,C
206G,206G,15,894,975,81,90,10,1,C
206G,206G,15,1114,1162,48,90,10,1,C
206G,206G,15,1225,1276,51,90,10,1,C
206G,206G,15,1290,1311,21,90,10,1,C
206G,206G,15,1435,1466,31,90,10,1,C
206G,206G,15,1513,1582,69,90,10,1,C
206G,206G,15,1620,1656,36,90,10,1,C
206G,206G,15,1710,1735,25,90,10,1,C
206G,206G,15,1780,1797,17,90,10,1,C
206G,206G,15,1856,1895,39,90,10,1,C
206G,206G,15,1973,2005,32,90,10,1,C
206G,206G,15,2089,2120,31,90,10,1,C
206G,206G,15,2219,2231,12,90,10,1,C
206G,206G,15,2321,2348,27,90,10,1,C
206G,206G,15,2390,2403,13,90,10,1,C
206G,206G,15,2420,2450,30,90,10,1,C
206G,206G,15,2475,2524,49,90,10,1,C
206G,206G,15,2582,2599,17,90,10,1,C
206G,206G,15,2686,2740,54,90,10,1,C
206G,206G,15,2933,2958,25,90,10,1,C
206G,206G,28,175,212,37,90,10,1,C
206G,206G,28,246,265,19,90,10,1,C
206G,206G,28,348,395,47,90,10,1,C
206G,206G,28,474,517,43,90,10,1,C
206G,206G,28,693,737,44,90,10,1,C
206G,206G,28,749,776,27,90,10,1,C
206G,206G,28,784,822,38,90,10,1,C
206G,206G,28,887,927,40,90,10,1,C
206G,206G,28,984,1029,45,90,10,1,C
206G,206G,28,1215,1241,26,90,10,1,C
206G,206G,28,1365,1395,30,90,10,1,C
206G,206G,28,1430,1452,22,90,10,1,C
206G,206G,28,1616,1633,17,90,10,1,C
206G,206G,28,1648,1660,12,90,10,1,C
206G,206G,28,1670,1684,14,90,10,1,C
206G,206G,28,1728,1750,22,90,10,1,C
206G,206G,28,1866,1907,41,90,10,1,C
206G,206G,28,1940,1995,55,90,10,1,C
206G,206G,28,2176,2235,59,90,10,1,C
206G,206G,28,2253,2295,42,90,10,1,C
206G,206G,28,2526,2545,19,90,10,1,C
206G,206G,28,2792,2818,26,90,10,1,C
206G,206G,28,2855,2867,12,90,10,1,C
206G,206G,28,2979,2993,14,90,10,1,C
207A,207A,2,0,20,20,90,10,1,C
207A,207A,2,40,77,37,90,10,1,C
207A,207A,2,88,110,22,90,10,1,C
207A,207A,2,126,168,42,90,10,1,C
207A,207A,2,210,290,80,90,10,1,C
207A,207A,2,332,356,24,90,10,1,C
207A,207A,2,370,449,79,90,10,1,C
207A,207A,2,518,551,33,90,10,1,C
207A,207A,2,698,711,13,90,10,1,C
207A,207A,2,737,760,23,90,10,1,C
207A,207A,2,770,794,24,90,10,1,C
207A,207A,2,803,818,15,90,10,1,C
207A,207A,2,916,937,21,90,10,1,C
207A,207A,2,1040,1071,31,90,10,1,C
207A,207A,2,1096,1146,50,90,10,1,C
207A,207A,2,1192,1226,34,90,10,1,C
207A,207A,2,1268,1316,48,90,10,1,C
207A,207A,2,1363,1387,24,90,10,1,C
207A,207A,2,1442,1472,30,90,10,1,C
207A,207A,2,1522,1542,20,90,10,1,C
207A,207A,2,1550,1575,25,90,10,1,C
207A,207A,2,1615,1630,15,90,10,1,C
207A,207A,2,1715,1774,59,90,10,1,C
207A,207A,2,1785,1800,15,90,10,1,C
207A,207A,2,1809,1925,116,90,10,1,C
207A,207A,2,2002,2119,117,90,10,1,C
207A,207A,2,2134,2173,39,90,10,1,C
207A,207A,2,2183,2254,71,90,10,1,C
207A,207A,2,2279,2303,24,90,10,1,C
207A,207A,2,2335,2355,20,90,10,1,C
207A,207A,2,2391,2405,14,90,10,1,C
207A,207A,2,2475,2490,15,90,10,1,C
207A,207A,2,2500,2516,16,90,10,1,C
207A,207A,2,2545,2569,24,90,10,1,C
207A,207A,2,2634,2689,55,90,10,1,C
207A,207A,2,2723,2795,72,90,10,1,C
207A,207A,2,2861,2905,44,90,10,1,C
207A,207A,2,2921,2973,52,90,10,1,C
207A,207A,2,2989,3000,11,90,10,1,C
207A,207A,15,34,169,135,90,10,1,C
207A,207A,15,184,199,15,90,10,1,C
207A,207A,15,219,285,66,90,10,1,C
207A,207A,15,300,340,40,90,10,1,C
207A,207A,15,360,381,21,90,10,1,C
207A,207A,15,429,488,59,90,10,1,C
207A,207A,15,518,705,187,90,10,1,C
207A,207A,15,758,802,44,90,10,1,C
207A,207A,15,811,966,155,90,10,1,C
207A,207A,15,989,1004,15,90,10,1,C
207A,207A,15,1022,1041,19,90,10,1,C
207A,207A,15,1081,1440,359,90,10,1,C
207A,207A,15,1447,1466,19,90,10,1,C
207A,207A,15,1471,1516,45,90,10,1,C
207A,207A,15,1561,1676,115,90,10,1,C
207A,207A,15,1691,1789,98,90,10,1,C
207A,207A,15,1820,1878,58,90,10,1,C
207A,207A,15,1914,1937,23,90,10,1,C
207A,207A,15,1969,2045,76,90,10,1,C
207A,207A,15,2054,2076,22,90,10,1,C
207A,207A,15,2104,2145,41,90,10,1,C
207A,207A,15,2169,2225,56,90,10,1,C
207A,207A,15,2247,2400,153,90,10,1,C
207A,207A,15,2407,2475,68,90,10,1,C
207A,207A,15,2606,2656,50,90,10,1,C
207A,207A,15,2705,2762,57,90,10,1,C
207A,207A,15,2820,2845,25,90,10,1,C
207A,207A,15,2855,2904,49,90,10,1,C
207A,207A,15,2901,2975,74,90,10,1,C
207A,207A,28,0,18,18,90,10,1,C
207A,207A,28,27,54,27,90,10,1,C
207A,207A,28,110,261,151,90,10,1,C
207A,207A,28,278,320,42,90,10,1,C
207A,207A,28,354,439,85,90,10,1,C
207A,207A,28,453,485,32,90,10,1,C
207A,207A,28,517,569,52,90,10,1,C
207A,207A,28,583,631,48,90,10,1,C
207A,207A,28,661,765,104,90,10,1,C
207A,207A,28,822,938,116,90,10,1,C
207A,207A,28,947,1026,79,90,10,1,C
207A,207A,28,1038,1071,33,90,10,1,C
207A,207A,28,1093,1141,48,90,10,1,C
207A,207A,28,1191,1246,55,90,10,1,C
207A,207A,28,1311,1365,54,90,10,1,C
207A,207A,28,1398,1491,93,90,10,1,C
207A,207A,28,1503,1522,19,90,10,1,C
207A,207A,28,1534,1721,187,90,10,1,C
207A,207A,28,1731,1919,188,90,10,1,C
207A,207A,28,1948,2014,66,90,10,1,C
207A,207A,28,2036,2094,58,90,10,1,C
207A,207A,28,2109,2148,39,90,10,1,C
207A,207A,28,2183,2312,129,90,10,1,C
207A,207A,28,2329,2510,181,90,10,1,C
207A,207A,28,2516,2529,13,90,10,1,C
207A,207A,28,2537,2609,72,90,10,1,C
207A,207A,28,2619,2670,51,90,10,1,C
207A,207A,28,2684,2699,15,90,10,1,C
207A,207A,28,2705,2755,50,90,10,1,C
207A,207A,28,2791,2833,42,90,10,1,C
207A,207A,28,2890,2924,34,90,10,1,C
207A,207A,28,2961,3000,39,90,10,1,C
207G,207G,2,7,36,29,90,10,1,C
207G,207G,2,45,172,127,90,10,1,C
207G,207G,2,141,512,371,90,10,1,C
207G,207G,2,495,512,17,90,10,1,C
207G,207G,2,788,852,64,90,10,1,C
207G,207G,2,888,915,27,90,10,1,C
207G,207G,2,921,980,59,90,10,1,C
207G,207G,2,993,1012,19,90,10,1,C
207G,207G,2,1017,1045,28,90,10,1,C
207G,207G,2,1078,1088,10,90,10,1,C
207G,207G,2,1114,1144,30,90,10,1,C
207G,207G,2,1153,1176,23,90,10,1,C
207G,207G,2,1185,1220,35,90,10,1,C
207G,207G,2,1226,1264,38,90,10,1,C
207G,207G,2,1269,1292,23,90,10,1,C
207G,207G,2,1301,1312,11,90,10,1,C
207G,207G,2,1317,1343,26,90,10,1,C
207G,207G,2,1370,1384,14,90,10,1,C
207G,207G,2,1423,1458,35,90,10,1,C
207G,207G,2,1470,1497,27,90,10,1,C
207G,207G,2,1509,1563,54,90,10,1,C
207G,207G,2,1588,1670,82,90,10,1,C
207G,207G,2,1718,1730,12,90,10,1,C
207G,207G,2,1734,1780,46,90,10,1,C
207G,207G,2,1830,1849,19,90,10,1,C
207G,207G,2,1860,1880,20,90,10,1,C
207G,207G,2,1886,1925,39,90,10,1,C
207G,207G,2,1935,1950,15,90,10,1,C
207G,207G,2,1970,1982,12,90,10,1,C
207G,207G,2,1996,2023,27,90,10,1,C
207G,207G,2,2029,2053,24,90,10,1,C
207G,207G,2,2084,2181,97,90,10,1,C
207G,207G,2,2141,2158,17,90,10,1,C
207G,207G,2,2198,2211,13,90,10,1,C
207G,207G,2,2219,2231,12,90,10,1,C
207G,207G,2,2275,2291,16,90,10,1,C
207G,207G,2,2295,2308,13,90,10,1,C
207G,207G,2,2315,2395,80,90,10,1,C
207G,207G,2,2420,2432,12,90,10,1,C
207G,207G,2,2447,2460,13,90,10,1,C
207G,207G,2,2470,2485,15,90,10,1,C
207G,207G,2,2490,2519,29,90,10,1,C
207G,207G,2,2541,2552,11,90,10,1,C
207G,207G,2,2557,2584,27,90,10,1,C
207G,207G,2,2668,2681,13,90,10,1,C
207G,207G,2,2686,2779,93,90,10,1,C
207G,207G,15,2,18,16,90,10,1,C
207G,207G,15,25,51,26,90,10,1,C
207G,207G,15,56,77,21,90,10,1,C
207G,207G,15,90,131,41,90,10,1,C
207G,207G,15,160,181,21,90,10,1,C
207G,207G,15,207,234,27,90,10,1,C
207G,207G,15,249,288,39,90,10,1,C
207G,207G,15,322,332,10,90,10,1,C
207G,207G,15,357,389,32,90,10,1,C
207G,207G,15,395,490,95,90,10,1,C
207G,207G,15,508,523,15,90,10,1,C
207G,207G,15,623,660,37,90,10,1,C
207G,207G,15,700,728,28,90,10,1,C
207G,207G,15,765,784,19,90,10,1,C
207G,207G,15,790,868,78,90,10,1,C
207G,207G,15,890,973,83,90,10,1,C
207G,207G,15,1035,1045,10,90,10,1,C
207G,207G,15,1069,1085,16,90,10,1,C
207G,207G,15,1100,1124,24,90,10,1,C
207G,207G,15,1148,1175,27,90,10,1,C
207G,207G,15,1190,1201,11,90,10,1,C
207G,207G,15,1238,1290,52,90,10,1,C
207G,207G,15,1589,1610,21,90,10,1,C
207G,207G,15,1680,1818,138,90,10,1,C
207G,207G,15,1990,2002,12,90,10,1,C
207G,207G,15,2010,2034,24,90,10,1,C
207G,207G,15,2066,2081,15,90,10,1,C
207G,207G,15,2134,2159,25,90,10,1,C
207G,207G,15,2173,2190,17,90,10,1,C
207G,207G,15,2196,2260,64,90,10,1,C
207G,207G,15,2303,2320,17,90,10,1,C
207G,207G,15,2365,2385,20,90,10,1,C
207G,207G,15,2443,2466,23,90,10,1,C
207G,207G,15,2475,2486,11,90,10,1,C
207G,207G,15,2533,2560,27,90,10,1,C
207G,207G,15,2565,2580,15,90,10,1,C
207G,207G,15,2680,2781,101,90,10,1,C
207G,207G,15,2786,2815,29,90,10,1,C
207G,207G,15,2828,2855,27,90,10,1,C
207G,207G,15,2871,2885,14,90,10,1,C
207G,207G,15,2891,2929,38,90,10,1,C
207G,207G,28,0,37,37,90,10,1,C
207G,207G,28,64,77,13,90,10,1,C
207G,207G,28,80,90,10,90,10,1,C
207G,207G,28,138,258,120,90,10,1,C
207G,207G,28,297,358,61,90,10,1,C
207G,207G,28,387,397,10,90,10,1,C
207G,207G,28,408,427,19,90,10,1,C
207G,207G,28,440,470,30,90,10,1,C
207G,207G,28,475,555,80,90,10,1,C
207G,207G,28,566,656,90,90,10,1,C
207G,207G,28,793,807,14,90,10,1,C
207G,207G,28,856,895,39,90,10,1,C
207G,207G,28,907,939,32,90,10,1,C
207G,207G,28,965,1008,43,90,10,1,C
207G,207G,28,1025,1040,15,90,10,1,C
207G,207G,28,1080,1092,12,90,10,1,C
207G,207G,28,1101,1150,49,90,10,1,C
207G,207G,28,1226,1269,43,90,10,1,C
207G,207G,28,1519,1549,30,90,10,1,C
207G,207G,28,1559,1571,12,90,10,1,C
207G,207G,28,1577,1624,47,90,10,1,C
207G,207G,28,1630,1650,20,90,10,1,C
207G,207G,28,1660,1673,13,90,10,1,C
207G,207G,28,1756,1773,17,90,10,1,C
207G,207G,28,1910,1932,22,90,10,1,C
207G,207G,28,2010,2046,36,90,10,1,C
207G,207G,28,2072,2089,17,90,10,1,C
207G,207G,28,2136,2238,102,90,10,1,C
207G,207G,28,2256,2295,39,90,10,1,C
207G,207G,28,2308,2337,29,90,10,1,C
207G,207G,28,2481,2655,174,90,10,1,C
207G,207G,28,2665,2691,26,90,10,1,C
207G,207G,28,2706,2732,26,90,10,1,C
207G,207G,28,2748,2762,14,90,10,1,C
207G,207G,28,2818,2853,35,90,10,1,C
207G,207G,28,2858,2871,13,90,10,1,C
207G,207G,28,2900,2912,12,90,10,1,C
207G,207G,28,2915,2930,15,90,10,1,C
208A,208A,2,42,92,50,90,10,1,C
208A,208A,2,113,154,41,90,10,1,C
208A,208A,2,205,242,37,90,10,1,C
208A,208A,2,279,310,31,90,10,1,C
208A,208A,2,318,339,21,90,10,1,C
208A,208A,2,355,387,32,90,10,1,C
208A,208A,2,395,426,31,90,10,1,C
208A,208A,2,431,544,113,90,10,1,C
208A,208A,2,615,650,35,90,10,1,C
208A,208A,2,690,745,55,90,10,1,C
208A,208A,2,795,889,94,90,10,1,C
208A,208A,2,918,954,36,90,10,1,C
208A,208A,2,972,1030,58,90,10,1,C
208A,208A,2,1046,1075,29,90,10,1,C
208A,208A,2,1110,1155,45,90,10,1,C
208A,208A,2,1193,1253,60,90,10,1,C
208A,208A,2,1306,1362,56,90,10,1,C
208A,208A,2,1381,1415,34,90,10,1,C
208A,208A,2,1407,1579,172,90,10,1,C
208A,208A,2,1453,1476,23,90,10,1,C
208A,208A,2,1611,1682,71,90,10,1,C
208A,208A,2,1695,1730,35,90,10,1,C
208A,208A,2,1815,1858,43,90,10,1,C
208A,208A,2,1872,1941,69,90,10,1,C
208A,208A,2,1984,2007,23,90,10,1,C
208A,208A,2,2058,2109,51,90,10,1,C
208A,208A,2,2183,2255,72,90,10,1,C
208A,208A,2,2305,2355,50,90,10,1,C
208A,208A,2,2389,2454,65,90,10,1,C
208A,208A,2,2479,2507,28,90,10,1,C
208A,208A,2,2528,2543,15,90,10,1,C
208A,208A,2,2588,2633,45,90,10,1,C
208A,208A,2,2668,2854,186,90,10,1,C
208A,208A,2,2876,2912,36,90,10,1,C
208A,208A,2,2926,3000,74,90,10,1,C
208A,208A,15,0,85,85,90,10,1,C
208A,208A,15,102,124,22,90,10,1,C
208A,208A,15,162,202,40,90,10,1,C
208A,208A,15,253,270,17,90,10,1,C
208A,208A,15,278,352,74,90,10,1,C
208A,208A,15,285,396,111,90,10,1,C
208A,208A,15,401,411,10,90,10,1,C
208A,208A,15,417,442,25,90,10,1,C
208A,208A,15,456,469,13,90,10,1,C
208A,208A,15,526,571,45,90,10,1,C
208A,208A,15,627,666,39,90,10,1,C
208A,208A,15,680,707,27,90,10,1,C
208A,208A,15,737,776,39,90,10,1,C
208A,208A,15,811,850,39,90,10,1,C
208A,208A,15,895,989,94,90,10,1,C
208A,208A,15,1022,1075,53,90,10,1,C
208A,208A,15,1126,1172,46,90,10,1,C
208A,208A,15,1186,1307,121,90,10,1,C
208A,208A,15,1345,1383,38,90,10,1,C
208A,208A,15,1419,1438,19,90,10,1,C
208A,208A,15,1454,1480,26,90,10,1,C
208A,208A,15,1519,1580,61,90,10,1,C
208A,208A,15,1591,1627,36,90,10,1,C
208A,208A,15,1632,1667,35,90,10,1,C
208A,208A,15,1727,1764,37,90,10,1,C
208A,208A,15,1805,1816,11,90,10,1,C
208A,208A,15,1834,1925,91,90,10,1,C
208A,208A,15,1980,2040,60,90,10,1,C
208A,208A,15,2099,2135,36,90,10,1,C
208A,208A,15,2173,2270,97,90,10,1,C
208A,208A,15,2301,2365,64,90,10,1,C
208A,208A,15,2411,2450,39,90,10,1,C
208A,208A,15,2502,2658,156,90,10,1,C
208A,208A,15,2673,2687,14,90,10,1,C
208A,208A,15,2701,2718,17,90,10,1,C
208A,208A,15,2747,2758,11,90,10,1,C
208A,208A,15,2770,2806,36,90,10,1,C
208A,208A,15,2830,2844,14,90,10,1,C
208A,208A,15,2857,2984,127,90,10,1,C
208A,208A,28,0,27,27,90,10,1,C
208A,208A,28,61,129,68,90,10,1,C
208A,208A,28,135,210,75,90,10,1,C
208A,208A,28,258,290,32,90,10,1,C
208A,208A,28,305,338,33,90,10,1,C
208A,208A,28,345,429,84,90,10,1,C
208A,208A,28,449,501,52,90,10,1,C
208A,208A,28,547,587,40,90,10,1,C
208A,208A,28,622,645,23,90,10,1,C
208A,208A,28,663,693,30,90,10,1,C
208A,208A,28,716,862,146,90,10,1,C
208A,208A,28,911,1011,100,90,10,1,C
208A,208A,28,1250,1275,25,90,10,1,C
208A,208A,28,1332,1355,23,90,10,1,C
208A,208A,28,1573,1608,35,90,10,1,C
208A,208A,28,1632,1650,18,90,10,1,C
208A,208A,28,1672,1690,18,90,10,1,C
208A,208A,28,1776,1786,10,90,10,1,C
208A,208A,28,1818,1859,41,90,10,1,C
208A,208A,28,1906,1922,16,90,10,1,C
208A,208A,28,1956,1983,27,90,10,1,C
208A,208A,28,2029,2048,19,90,10,1,C
208A,208A,28,2115,2145,30,90,10,1,C
208A,208A,28,2365,2411,46,90,10,1,C
208A,208A,28,2425,2445,20,90,10,1,C
208A,208A,28,2616,2629,13,90,10,1,C
208A,208A,28,2636,2688,52,90,10,1,C
208A,208A,28,2736,2795,59,90,10,1,C
208A,208A,28,2819,2879,60,90,10,1,C
208A,208A,28,2896,2959,63,90,10,1,C
208A,208A,28,2973,3000,27,90,10,1,C
208A,208A,28,2979,3000,21,90,10,1,C
208G,208G,2,0,35,35,90,10,1,C
208G,208G,2,100,112,12,90,10,1,C
208G,208G,2,120,136,16,90,10,1,C
208G,208G,2,168,281,113,90,10,1,C
208G,208G,2,291,310,19,90,10,1,C
208G,208G,2,321,357,36,90,10,1,C
208G,208G,2,388,406,18,90,10,1,C
208G,208G,2,412,484,72,90,10,1,C
208G,208G,2,505,537,32,90,10,1,C
208G,208G,2,549,611,62,90,10,1,C
208G,208G,2,632,715,83,90,10,1,C
208G,208G,2,735,837,102,90,10,1,C
208G,208G,2,850,938,88,90,10,1,C
208G,208G,2,951,976,25,90,10,1,C
208G,208G,2,1028,1055,27,90,10,1,C
208G,208G,2,1094,1119,25,90,10,1,C
208G,208G,2,1135,1152,17,90,10,1,C
208G,208G,2,1171,1290,119,90,10,1,C
208G,208G,2,1329,1376,47,90,10,1,C
208G,208G,2,1384,1791,407,90,10,1,C
208G,208G,2,1805,2048,243,90,10,1,C
208G,208G,2,2057,2090,33,90,10,1,C
208G,208G,2,2113,2131,18,90,10,1,C
208G,208G,2,2145,2170,25,90,10,1,C
208G,208G,2,2177,2242,65,90,10,1,C
208G,208G,2,2259,2281,22,90,10,1,C
208G,208G,2,2293,2361,68,90,10,1,C
208G,208G,2,2377,2391,14,90,10,1,C
208G,208G,2,2440,2496,56,90,10,1,C
208G,208G,2,2520,2603,83,90,10,1,C
208G,208G,2,2610,2741,131,90,10,1,C
208G,208G,2,2785,3000,215,90,10,1,C
208G,208G,15,0,26,26,90,10,1,C
208G,208G,15,57,90,33,90,10,1,C
208G,208G,15,101,151,50,90,10,1,C
208G,208G,15,170,183,13,90,10,1,C
208G,208G,15,195,234,39,90,10,1,C
208G,208G,15,291,327,36,90,10,1,C
208G,208G,15,341,431,90,90,10,1,C
208G,208G,15,456,477,21,90,10,1,C
208G,208G,15,482,502,20,90,10,1,C
208G,208G,15,513,546,33,90,10,1,C
208G,208G,15,551,565,14,90,10,1,C
208G,208G,15,585,602,17,90,10,1,C
208G,208G,15,655,668,13,90,10,1,C
208G,208G,15,835,852,17,90,10,1,C
208G,208G,15,873,905,32,90,10,1,C
208G,208G,15,943,997,54,90,10,1,C
208G,208G,15,1007,1050,43,90,10,1,C
208G,208G,15,1062,1076,14,90,10,1,C
208G,208G,15,1095,1149,54,90,10,1,C
208G,208G,15,1160,1210,50,90,10,1,C
208G,208G,15,1265,1280,15,90,10,1,C
208G,208G,15,1345,1438,93,90,10,1,C
208G,208G,15,1452,1476,24,90,10,1,C
208G,208G,15,1532,1566,34,90,10,1,C
208G,208G,15,1575,1647,72,90,10,1,C
208G,208G,15,1670,1719,49,90,10,1,C
208G,208G,15,1728,1775,47,90,10,1,C
208G,208G,15,1800,1824,24,90,10,1,C
208G,208G,15,1871,1927,56,90,10,1,C
208G,208G,15,1933,1946,13,90,10,1,C
208G,208G,15,1975,2008,33,90,10,1,C
208G,208G,15,2054,2066,12,90,10,1,C
208G,208G,15,2078,2090,12,90,10,1,C
208G,208G,15,2111,2318,207,90,10,1,C
208G,208G,15,2336,2349,13,90,10,1,C
208G,208G,15,2365,2390,25,90,10,1,C
208G,208G,15,2429,2613,184,90,10,1,C
208G,208G,15,2669,2701,32,90,10,1,C
208G,208G,15,2720,2777,57,90,10,1,C
208G,208G,15,2801,2826,25,90,10,1,C
208G,208G,15,2832,2848,16,90,10,1,C
208G,208G,15,2853,2914,61,90,10,1,C
208G,208G,15,2926,2965,39,90,10,1,C
208G,208G,15,2987,3000,13,90,10,1,C
208G,208G,28,0,15,15,90,10,1,C
208G,208G,28,35,60,25,90,10,1,C
208G,208G,28,94,130,36,90,10,1,C
208G,208G,28,150,160,10,90,10,1,C
208G,208G,28,191,214,23,90,10,1,C
208G,208G,28,223,245,22,90,10,1,C
208G,208G,28,308,322,14,90,10,1,C
208G,208G,28,400,414,14,90,10,1,C
208G,208G,28,532,551,19,90,10,1,C
208G,208G,28,653,670,17,90,10,1,C
208G,208G,28,714,734,20,90,10,1,C
208G,208G,28,750,760,10,90,10,1,C
208G,208G,28,781,791,10,90,10,1,C
208G,208G,28,860,876,16,90,10,1,C
208G,208G,28,890,906,16,90,10,1,C
208G,208G,28,983,1000,17,90,10,1,C
208G,208G,28,1028,1042,14,90,10,1,C
208G,208G,28,1137,1165,28,90,10,1,C
208G,208G,28,1213,1249,36,90,10,1,C
208G,208G,28,1274,1290,16,90,10,1,C
208G,208G,28,1297,1335,38,90,10,1,C
208G,208G,28,1552,1580,28,90,10,1,C
208G,208G,28,1640,1650,10,90,10,1,C
208G,208G,28,1663,1675,12,90,10,1,C
208G,208G,28,1680,1725,45,90,10,1,C
208G,208G,28,1776,1789,13,90,10,1,C
208G,208G,28,1810,1837,27,90,10,1,C
208G,208G,28,1842,1865,23,90,10,1,C
208G,208G,28,1872,1917,45,90,10,1,C
208G,208G,28,1932,1948,16,90,10,1,C
208G,208G,28,1955,2006,51,90,10,1,C
208G,208G,28,2070,2080,10,90,10,1,C
208G,208G,28,2085,2164,79,90,10,1,C
208G,208G,28,2232,2244,12,90,10,1,C
208G,208G,28,2287,2334,47,90,10,1,C
208G,208G,28,2356,2369,13,90,10,1,C
208G,208G,28,2392,2430,38,90,10,1,C
208G,208G,28,2458,2510,52,90,10,1,C
208G,208G,28,2526,2577,51,90,10,1,C
208G,208G,28,2612,2625,13,90,10,1,C
208G,208G,28,2803,2816,13,90,10,1,C
208G,208G,28,2836,2957,121,90,10,1,C
208G,208G,28,2862,2890,28,90,10,1,C
209A,209A,2,0,16,16,90,10,1,C
209A,209A,2,29,40,11,90,10,1,C
209A,209A,2,249,271,22,90,10,1,C
209A,209A,2,405,423,18,90,10,1,C
209A,209A,2,665,682,17,90,10,1,C
209A,209A,2,715,731,16,90,10,1,C
209A,209A,2,1064,1080,16,90,10,1,C
209A,209A,2,1206,1235,29,90,10,1,C
209A,209A,2,1313,1375,62,90,10,1,C
209A,209A,2,1540,1553,13,90,10,1,C
209A,209A,2,1602,1614,12,90,10,1,C
209A,209A,2,1696,1722,26,90,10,1,C
209A,209A,2,1769,1792,23,90,10,1,C
209A,209A,2,1836,1905,69,90,10,1,C
209A,209A,2,1932,1958,26,90,10,1,C
209A,209A,2,2102,2112,10,90,10,1,C
209A,209A,2,2141,2212,71,90,10,1,C
209A,209A,2,2232,2278,46,90,10,1,C
209A,209A,2,2299,2310,11,90,10,1,C
209A,209A,2,2432,2455,23,90,10,1,C
209A,209A,2,2495,2518,23,90,10,1,C
209A,209A,2,2610,2630,20,90,10,1,C
209A,209A,2,2705,2717,12,90,10,1,C
209A,209A,2,2725,2742,17,90,10,1,C
209A,209A,2,2920,2954,34,90,10,1,C
209A,209A,15,171,190,19,90,10,1,C
209A,209A,15,467,485,18,90,10,1,C
209A,209A,15,495,519,24,90,10,1,C
209A,209A,15,555,573,18,90,10,1,C
209A,209A,15,721,750,29,90,10,1,C
209A,209A,15,786,799,13,90,10,1,C
209A,209A,15,960,986,26,90,10,1,C
209A,209A,15,1065,1083,18,90,10,1,C
209A,209A,15,1119,1137,18,90,10,1,C
209A,209A,15,1320,1340,20,90,10,1,C
209A,209A,15,1364,1382,18,90,10,1,C
209A,209A,15,1482,1497,15,90,10,1,C
209A,209A,15,1521,1558,37,90,10,1,C
209A,209A,15,1574,1586,12,90,10,1,C
209A,209A,15,1635,1668,33,90,10,1,C
209A,209A,15,1755,1779,24,90,10,1,C
209A,209A,15,1790,1801,11,90,10,1,C
209A,209A,15,2084,2125,41,90,10,1,C
209A,209A,15,2166,2189,23,90,10,1,C
209A,209A,15,2317,2345,28,90,10,1,C
209A,209A,15,2351,2380,29,90,10,1,C
209A,209A,15,2442,2455,13,90,10,1,C
209A,209A,15,2591,2625,34,90,10,1,C
209A,209A,15,2652,2662,10,90,10,1,C
209A,209A,15,2810,2833,23,90,10,1,C
209A,209A,15,2988,3000,12,90,10,1,C
209A,209A,28,250,291,41,90,10,1,C
209A,209A,28,370,410,40,90,10,1,C
209A,209A,28,508,526,18,90,10,1,C
209A,209A,28,595,622,27,90,10,1,C
209A,209A,28,775,833,58,90,10,1,C
209A,209A,28,923,1000,77,90,10,1,C
209A,209A,28,1089,1123,34,90,10,1,C
209A,209A,28,1433,1492,59,90,10,1,C
209A,209A,28,1516,1541,25,90,10,1,C
209A,209A,28,1787,1803,16,90,10,1,C
209A,209A,28,1850,1879,29,90,10,1,C
209A,209A,28,1902,1935,33,90,10,1,C
209A,209A,28,1941,1961,20,90,10,1,C
209A,209A,28,2130,2141,11,90,10,1,C
209A,209A,28,2380,2402,22,90,10,1,C
209A,209A,28,2405,2429,24,90,10,1,C
209A,209A,28,2551,2589,38,90,10,1,C
209A,209A,28,2672,2684,12,90,10,1,C
209A,209A,28,2788,2819,31,90,10,1,C
209G,209G,2,319,330,11,90,10,1,C
209G,209G,2,858,962,104,90,10,1,C
209G,209G,2,1139,1154,15,90,10,1,C
209G,209G,2,1240,1263,23,90,10,1,C
209G,209G,2,1535,1567,32,90,10,1,C
209G,209G,2,1601,1611,10,90,10,1,C
209G,209G,2,1622,1688,66,90,10,1,C
209G,209G,2,1705,1717,12,90,10,1,C
209G,209G,2,1742,1754,12,90,10,1,C
209G,209G,2,1815,1855,40,90,10,1,C
209G,209G,2,1869,1988,119,90,10,1,C
209G,209G,2,1900,1912,12,90,10,1,C
209G,209G,2,1923,1952,29,90,10,1,C
209G,209G,2,1998,2018,20,90,10,1,C
209G,209G,2,2090,2101,11,90,10,1,C
209G,209G,2,2154,2169,15,90,10,1,C
209G,209G,2,2200,2219,19,90,10,1,C
209G,209G,2,2374,2389,15,90,10,1,C
209G,209G,15,0,17,17,90,10,1,C
209G,209G,15,25,36,11,90,10,1,C
209G,209G,15,550,560,10,90,10,1,C
209G,209G,15,574,584,10,90,10,1,C
209G,209G,15,612,640,28,90,10,1,C
209G,209G,15,660,688,28,90,10,1,C
209G,209G,15,700,711,11,90,10,1,C
209G,209G,15,786,798,12,90,10,1,C
209G,209G,15,870,904,34,90,10,1,C
209G,209G,15,945,967,22,90,10,1,C
209G,209G,15,1090,1109,19,90,10,1,C
209G,209G,15,1125,1136,11,90,10,1,C
209G,209G,15,1160,1180,20,90,10,1,C
209G,209G,15,1224,1253,29,90,10,1,C
209G,209G,15,1403,1421,18,90,10,1,C
209G,209G,15,1754,1780,26,90,10,1,C
209G,209G,15,1833,1865,32,90,10,1,C
209G,209G,15,2169,2203,34,90,10,1,C
209G,209G,15,2325,2372,47,90,10,1,C
209G,209G,15,2414,2464,50,90,10,1,C
209G,209G,15,2528,2548,20,90,10,1,C
209G,209G,15,2714,2758,44,90,10,1,C
209G,209G,15,2851,2897,46,90,10,1,C
209G,209G,28,0,34,34,90,10,1,C
209G,209G,28,40,64,24,90,10,1,C
209G,209G,28,102,141,39,90,10,1,C
209G,209G,28,160,170,10,90,10,1,C
209G,209G,28,246,310,64,90,10,1,C
209G,209G,28,419,444,25,90,10,1,C
209G,209G,28,520,584,64,90,10,1,C
209G,209G,28,889,902,13,90,10,1,C
209G,209G,28,1378,1394,16,90,10,1,C
209G,209G,28,1406,1419,13,90,10,1,C
209G,209G,28,1484,1505,21,90,10,1,C
209G,209G,28,1557,1597,40,90,10,1,C
209G,209G,28,1648,1675,27,90,10,1,C
209G,209G,28,2184,2197,13,90,10,1,C
209G,209G,28,2318,2347,29,90,10,1,C
209G,209G,28,2372,2405,33,90,10,1,C
209G,209G,28,2440,2454,14,90,10,1,C
209G,209G,28,2501,2512,11,90,10,1,C
209G,209G,28,2924,2958,34,90,10,1,C
210A,210A,2,0,15,15,90,10,1,C
210A,210A,2,114,165,51,90,10,1,C
210A,210A,2,223,238,15,90,10,1,C
210A,210A,2,309,332,23,90,10,1,C
210A,210A,2,407,424,17,90,10,1,C
210A,210A,2,505,520,15,90,10,1,C
210A,210A,2,650,665,15,90,10,1,C
210A,210A,2,700,710,10,90,10,1,C
210A,210A,2,728,750,22,90,10,1,C
210A,210A,2,1089,1150,61,90,10,1,C
210A,210A,2,1184,1221,37,90,10,1,C
210A,210A,2,1248,1308,60,90,10,1,C
210A,210A,2,1394,1435,41,90,10,1,C
210A,210A,2,1501,1520,19,90,10,1,C
210A,210A,2,1743,1780,37,90,10,1,C
210A,210A,2,1810,1833,23,90,10,1,C
210A,210A,2,1969,2030,61,90,10,1,C
210A,210A,2,2104,2129,25,90,10,1,C
210A,210A,2,2160,2176,16,90,10,1,C
210A,210A,2,2225,2247,22,90,10,1,C
210A,210A,2,2306,2325,19,90,10,1,C
210A,210A,2,2456,2480,24,90,10,1,C
210A,210A,2,2531,2598,67,90,10,1,C
210A,210A,2,2691,2721,30,90,10,1,C
210A,210A,2,2751,2770,19,90,10,1,C
210A,210A,2,2825,2888,63,90,10,1,C
210A,210A,2,2944,2964,20,90,10,1,C
210A,210A,2,2980,3000,20,90,10,1,C
210A,210A,15,94,111,17,90,10,1,C
210A,210A,15,177,211,34,90,10,1,C
210A,210A,15,272,304,32,90,10,1,C
210A,210A,15,354,373,19,90,10,1,C
210A,210A,15,390,403,13,90,10,1,C
210A,210A,15,510,541,31,90,10,1,C
210A,210A,15,562,578,16,90,10,1,C
210A,210A,15,586,640,54,90,10,1,C
210A,210A,15,645,671,26,90,10,1,C
210A,210A,15,993,1022,29,90,10,1,C
210A,210A,15,1046,1087,41,90,10,1,C
210A,210A,15,1160,1173,13,90,10,1,C
210A,210A,15,1180,1202,22,90,10,1,C
210A,210A,15,1207,1224,17,90,10,1,C
210A,210A,15,1254,1302,48,90,10,1,C
210A,210A,15,1352,1399,47,90,10,1,C
210A,210A,15,1664,1737,73,90,10,1,C
210A,210A,15,1889,1923,34,90,10,1,C
210A,210A,15,2161,2184,23,90,10,1,C
210A,210A,15,2289,2301,12,90,10,1,C
210A,210A,15,2457,2470,13,90,10,1,C
210A,210A,15,2658,2677,19,90,10,1,C
210A,210A,15,2717,2732,15,90,10,1,C
210A,210A,15,2754,2767,13,90,10,1,C
210A,210A,15,2830,2851,21,90,10,1,C
210A,210A,15,2877,2931,54,90,10,1,C
210A,210A,28,0,28,28,90,10,1,C
210A,210A,28,119,159,40,90,10,1,C
210A,210A,28,198,224,26,90,10,1,C
210A,210A,28,262,291,29,90,10,1,C
210A,210A,28,319,358,39,90,10,1,C
210A,210A,28,423,452,29,90,10,1,C
210A,210A,28,457,472,15,90,10,1,C
210A,210A,28,554,591,37,90,10,1,C
210A,210A,28,608,625,17,90,10,1,C
210A,210A,28,665,685,20,90,10,1,C
210A,210A,28,703,736,33,90,10,1,C
210A,210A,28,828,849,21,90,10,1,C
210A,210A,28,935,966,31,90,10,1,C
210A,210A,28,1010,1080,70,90,10,1,C
210A,210A,28,1173,1206,33,90,10,1,C
210A,210A,28,1275,1294,19,90,10,1,C
210A,210A,28,1325,1380,55,90,10,1,C
210A,210A,28,1385,1415,30,90,10,1,C
210A,210A,28,1421,1436,15,90,10,1,C
210A,210A,28,1579,1592,13,90,10,1,C
210A,210A,28,1603,1643,40,90,10,1,C
210A,210A,28,1736,1757,21,90,10,1,C
210A,210A,28,1802,1830,28,90,10,1,C
210A,210A,28,1905,1968,63,90,10,1,C
210A,210A,28,1983,2013,30,90,10,1,C
210A,210A,28,2116,2145,29,90,10,1,C
210A,210A,28,2168,2182,14,90,10,1,C
210A,210A,28,2215,2259,44,90,10,1,C
210A,210A,28,2339,2360,21,90,10,1,C
210A,210A,28,2400,2418,18,90,10,1,C
210A,210A,28,2467,2530,63,90,10,1,C
210A,210A,28,2559,2576,17,90,10,1,C
210A,210A,28,2604,2641,37,90,10,1,C
210A,210A,28,2655,2671,16,90,10,1,C
210A,210A,28,2704,2759,55,90,10,1,C
210A,210A,28,2774,2805,31,90,10,1,C
210A,210A,28,2868,2930,62,90,10,1,C
210A,210A,28,2960,2976,16,90,10,1,C
210A,210A,28,2988,3000,12,90,10,1,C
210G,210G,2,19,30,11,90,10,1,C
210G,210G,2,158,174,16,90,10,1,C
210G,210G,2,190,207,17,90,10,1,C
210G,210G,2,297,313,16,90,10,1,C
210G,210G,2,328,358,30,90,10,1,C
210G,210G,2,367,413,46,90,10,1,C
210G,210G,2,432,484,52,90,10,1,C
210G,210G,2,496,629,133,90,10,1,C
210G,210G,2,715,739,24,90,10,1,C
210G,210G,2,771,788,17,90,10,1,C
210G,210G,2,841,891,50,90,10,1,C
210G,210G,2,917,943,26,90,10,1,C
210G,210G,2,952,978,26,90,10,1,C
210G,210G,2,1021,1118,97,90,10,1,C
210G,210G,2,1131,1170,39,90,10,1,C
210G,210G,2,1180,1244,64,90,10,1,C
210G,210G,2,1318,1329,11,90,10,1,C
210G,210G,2,1339,1365,26,90,10,1,C
210G,210G,2,1374,1387,13,90,10,1,C
210G,210G,2,1476,1494,18,90,10,1,C
210G,210G,2,1513,1525,12,90,10,1,C
210G,210G,2,1619,1655,36,90,10,1,C
210G,210G,2,1776,2058,282,90,10,1,C
210G,210G,2,2074,2132,58,90,10,1,C
210G,210G,2,2138,2269,131,90,10,1,C
210G,210G,2,2328,2361,33,90,10,1,C
210G,210G,2,2379,2433,54,90,10,1,C
210G,210G,2,2454,2509,55,90,10,1,C
210G,210G,2,2515,2549,34,90,10,1,C
210G,210G,2,2557,2624,67,90,10,1,C
210G,210G,2,2658,2701,43,90,10,1,C
210G,210G,2,2706,2726,20,90,10,1,C
210G,210G,2,2743,2774,31,90,10,1,C
210G,210G,2,2783,2800,17,90,10,1,C
210G,210G,2,2824,3000,176,90,10,1,C
210G,210G,15,0,49,49,90,10,1,C
210G,210G,15,91,147,56,90,10,1,C
210G,210G,15,162,176,14,90,10,1,C
210G,210G,15,222,253,31,90,10,1,C
210G,210G,15,308,333,25,90,10,1,C
210G,210G,15,405,438,33,90,10,1,C
210G,210G,15,450,583,133,90,10,1,C
210G,210G,15,590,626,36,90,10,1,C
210G,210G,15,662,686,24,90,10,1,C
210G,210G,15,700,722,22,90,10,1,C
210G,210G,15,732,1050,318,90,10,1,C
210G,210G,15,1080,1282,202,90,10,1,C
210G,210G,15,1293,1395,102,90,10,1,C
210G,210G,15,1405,1495,90,90,10,1,C
210G,210G,15,1516,2120,604,90,10,1,C
210G,210G,15,2152,2174,22,90,10,1,C
210G,210G,15,2201,2260,59,90,10,1,C
210G,210G,15,2271,2333,62,90,10,1,C
210G,210G,15,2355,2392,37,90,10,1,C
210G,210G,15,2480,2497,17,90,10,1,C
210G,210G,15,2510,2572,62,90,10,1,C
210G,210G,15,2591,2655,64,90,10,1,C
210G,210G,15,2692,2814,122,90,10,1,C
210G,210G,15,2832,3000,168,90,10,1,C
210G,210G,28,0,280,280,90,10,1,C
210G,210G,28,417,441,24,90,10,1,C
210G,210G,28,491,519,28,90,10,1,C
210G,210G,28,531,548,17,90,10,1,C
210G,210G,28,561,699,138,90,10,1,C
210G,210G,28,712,761,49,90,10,1,C
210G,210G,28,771,789,18,90,10,1,C
210G,210G,28,814,826,12,90,10,1,C
210G,210G,28,835,920,85,90,10,1,C
210G,210G,28,936,1213,277,90,10,1,C
210G,210G,28,1236,1300,64,90,10,1,C
210G,210G,28,1329,1472,143,90,10,1,C
210G,210G,28,1477,1498,21,90,10,1,C
210G,210G,28,1548,1615,67,90,10,1,C
210G,210G,28,1778,1811,33,90,10,1,C
210G,210G,28,1819,1868,49,90,10,1,C
210G,210G,28,1903,1915,12,90,10,1,C
210G,210G,28,1940,1989,49,90,10,1,C
210G,210G,28,2004,2095,91,90,10,1,C
210G,210G,28,2115,2147,32,90,10,1,C
210G,210G,28,2153,2230,77,90,10,1,C
210G,210G,28,2249,2349,100,90,10,1,C
210G,210G,28,2296,2379,83,90,10,1,C
210G,210G,28,2358,2442,84,90,10,1,C
210G,210G,28,2427,2493,66,90,10,1,C
210G,210G,28,2544,2561,17,90,10,1,C
210G,210G,28,2609,2642,33,90,10,1,C
210G,210G,28,2649,2660,11,90,10,1,C
210G,210G,28,2666,2678,12,90,10,1,C
210G,210G,28,2694,2723,29,90,10,1,C
210G,210G,28,2811,2844,33,90,10,1,C
210G,210G,28,2888,2905,17,90,10,1,C
210G,210G,28,2947,2953,6,90,10,1,C
211A,211A,2,0,22,22,90,10,1,C
211A,211A,2,29,43,14,90,10,1,C
211A,211A,2,62,76,14,90,10,1,C
211A,211A,2,109,157,48,90,10,1,C
211A,211A,2,145,272,127,90,10,1,C
211A,211A,2,290,326,36,90,10,1,C
211A,211A,2,333,383,50,90,10,1,C
211A,211A,2,391,561,170,90,10,1,C
211A,211A,2,596,676,80,90,10,1,C
211A,211A,2,693,737,44,90,10,1,C
211A,211A,2,747,841,94,90,10,1,C
211A,211A,2,855,880,25,90,10,1,C
211A,211A,2,899,910,11,90,10,1,C
211A,211A,2,921,945,24,90,10,1,C
211A,211A,2,951,990,39,90,10,1,C
211A,211A,2,1006,1070,64,90,10,1,C
211A,211A,2,1102,1137,35,90,10,1,C
211A,211A,2,1212,1239,27,90,10,1,C
211A,211A,2,1286,1341,55,90,10,1,C
211A,211A,2,1356,1384,28,90,10,1,C
211A,211A,2,1411,1488,77,90,10,1,C
211A,211A,2,1500,1540,40,90,10,1,C
211A,211A,2,1571,1602,31,90,10,1,C
211A,211A,2,1668,1690,22,90,10,1,C
211A,211A,2,1739,1791,52,90,10,1,C
211A,211A,2,1800,1829,29,90,10,1,C
211A,211A,2,1849,1933,84,90,10,1,C
211A,211A,2,1945,1978,33,90,10,1,C
211A,211A,2,1991,2037,46,90,10,1,C
211A,211A,2,2050,2062,12,90,10,1,C
211A,211A,2,2062,2102,40,90,10,1,C
211A,211A,2,2115,2175,60,90,10,1,C
211A,211A,2,2204,2216,12,90,10,1,C
211A,211A,2,2252,2307,55,90,10,1,C
211A,211A,2,2331,2410,79,90,10,1,C
211A,211A,2,2458,2557,99,90,10,1,C
211A,211A,2,2573,2612,39,90,10,1,C
211A,211A,2,2633,2698,65,90,10,1,C
211A,211A,2,2722,2755,33,90,10,1,C
211A,211A,2,2769,2804,35,90,10,1,C
211A,211A,2,2802,2842,40,90,10,1,C
211A,211A,2,2893,2906,13,90,10,1,C
211A,211A,2,2969,3000,31,90,10,1,C
211A,211A,15,30,60,30,90,10,1,C
211A,211A,15,95,119,24,90,10,1,C
211A,211A,15,125,142,17,90,10,1,C
211A,211A,15,150,175,25,90,10,1,C
211A,211A,15,210,276,66,90,10,1,C
211A,211A,15,305,365,60,90,10,1,C
211A,211A,15,410,445,35,90,10,1,C
211A,211A,15,471,512,41,90,10,1,C
211A,211A,15,525,566,41,90,10,1,C
211A,211A,15,590,633,43,90,10,1,C
211A,211A,15,663,732,69,90,10,1,C
211A,211A,15,799,985,186,90,10,1,C
211A,211A,15,1017,1034,17,90,10,1,C
211A,211A,15,1054,1112,58,90,10,1,C
211A,211A,15,1144,1228,84,90,10,1,C
211A,211A,15,1305,1408,103,90,10,1,C
211A,211A,15,1428,1442,14,90,10,1,C
211A,211A,15,1468,1500,32,90,10,1,C
211A,211A,15,1549,1595,46,90,10,1,C
211A,211A,15,1641,1681,40,90,10,1,C
211A,211A,15,1762,1804,42,90,10,1,C
211A,211A,15,1835,1900,65,90,10,1,C
211A,211A,15,1917,1945,28,90,10,1,C
211A,211A,15,1951,2034,83,90,10,1,C
211A,211A,15,2093,2105,12,90,10,1,C
211A,211A,15,2122,2129,7,90,10,1,C
211A,211A,15,2196,2217,21,90,10,1,C
211A,211A,15,2226,2397,171,90,10,1,C
211A,211A,15,2410,2440,30,90,10,1,C
211A,211A,15,2467,2527,60,90,10,1,C
211A,211A,15,2537,2551,14,90,10,1,C
211A,211A,15,2570,2639,69,90,10,1,C
211A,211A,15,2656,2684,28,90,10,1,C
211A,211A,15,2730,2735,5,90,10,1,C
211A,211A,15,2813,2831,18,90,10,1,C
211A,211A,15,2912,2971,59,90,10,1,C
211A,211A,28,47,115,68,90,10,1,C
211A,211A,28,135,173,38,90,10,1,C
211A,211A,28,263,350,87,90,10,1,C
211A,211A,28,357,392,35,90,10,1,C
211A,211A,28,400,480,80,90,10,1,C
211A,211A,28,490,541,51,90,10,1,C
211A,211A,28,552,594,42,90,10,1,C
211A,211A,28,611,632,21,90,10,1,C
211A,211A,28,652,795,143,90,10,1,C
211A,211A,28,808,833,25,90,10,1,C
211A,211A,28,843,939,96,90,10,1,C
211A,211A,28,1049,1091,42,90,10,1,C
211A,211A,28,1152,1174,22,90,10,1,C
211A,211A,28,1185,1222,37,90,10,1,C
211A,211A,28,1280,1324,44,90,10,1,C
211A,211A,28,1351,1422,71,90,10,1,C
211A,211A,28,1431,1457,26,90,10,1,C
211A,211A,28,1462,1530,68,90,10,1,C
211A,211A,28,1552,1611,59,90,10,1,C
211A,211A,28,1624,1698,74,90,10,1,C
211A,211A,28,1779,1817,38,90,10,1,C
211A,211A,28,1830,1884,54,90,10,1,C
211A,211A,28,1979,2011,32,90,10,1,C
211A,211A,28,2147,2163,16,90,10,1,C
211A,211A,28,2212,2243,31,90,10,1,C
211A,211A,28,2311,2324,13,90,10,1,C
211A,211A,28,2395,2456,61,90,10,1,C
211A,211A,28,2480,2530,50,90,10,1,C
211A,211A,28,2650,2672,22,90,10,1,C
211A,211A,28,2690,2753,63,90,10,1,C
211A,211A,28,2777,2805,28,90,10,1,C
211A,211A,28,2811,2830,19,90,10,1,C
211A,211A,28,2925,2992,67,90,10,1,C
211G,211G,2,0,10,10,90,10,1,C
211G,211G,2,55,72,17,90,10,1,C
211G,211G,2,91,130,39,90,10,1,C
211G,211G,2,177,200,23,90,10,1,C
211G,211G,2,231,243,12,90,10,1,C
211G,211G,2,288,313,25,90,10,1,C
211G,211G,2,322,358,36,90,10,1,C
211G,211G,2,372,418,46,90,10,1,C
211G,211G,2,528,545,17,90,10,1,C
211G,211G,2,556,577,21,90,10,1,C
211G,211G,2,605,639,34,90,10,1,C
211G,211G,2,651,678,27,90,10,1,C
211G,211G,2,695,715,20,90,10,1,C
211G,211G,2,784,801,17,90,10,1,C
211G,211G,2,845,860,15,90,10,1,C
211G,211G,2,865,882,17,90,10,1,C
211G,211G,2,936,959,23,90,10,1,C
211G,211G,2,990,1000,10,90,10,1,C
211G,211G,2,1095,1140,45,90,10,1,C
211G,211G,2,1151,1183,32,90,10,1,C
211G,211G,2,1229,1254,25,90,10,1,C
211G,211G,2,1278,1302,24,90,10,1,C
211G,211G,2,1318,1354,36,90,10,1,C
211G,211G,2,1511,1538,27,90,10,1,C
211G,211G,2,1638,1658,20,90,10,1,C
211G,211G,2,1667,1694,27,90,10,1,C
211G,211G,2,1766,1797,31,90,10,1,C
211G,211G,2,1915,1935,20,90,10,1,C
211G,211G,2,2010,2025,15,90,10,1,C
211G,211G,2,2146,2169,23,90,10,1,C
211G,211G,2,2268,2280,12,90,10,1,C
211G,211G,2,2436,2540,104,90,10,1,C
211G,211G,2,2609,2620,11,90,10,1,C
211G,211G,2,2625,2635,10,90,10,1,C
211G,211G,15,17,53,36,90,10,1,C
211G,211G,15,86,119,33,90,10,1,C
211G,211G,15,128,138,10,90,10,1,C
211G,211G,15,155,173,18,90,10,1,C
211G,211G,15,272,293,21,90,10,1,C
211G,211G,15,682,708,26,90,10,1,C
211G,211G,15,716,747,31,90,10,1,C
211G,211G,15,788,803,15,90,10,1,C
211G,211G,15,823,840,17,90,10,1,C
211G,211G,15,862,872,10,90,10,1,C
211G,211G,15,887,950,63,90,10,1,C
211G,211G,15,1030,1052,22,90,10,1,C
211G,211G,15,1069,1091,22,90,10,1,C
211G,211G,15,1109,1132,23,90,10,1,C
211G,211G,15,1144,1190,46,90,10,1,C
211G,211G,15,1303,1320,17,90,10,1,C
211G,211G,15,1336,1380,44,90,10,1,C
211G,211G,15,1730,1772,42,90,10,1,C
211G,211G,15,1798,1892,94,90,10,1,C
211G,211G,15,1906,1930,24,90,10,1,C
211G,211G,15,1975,1985,10,90,10,1,C
211G,211G,15,1993,2100,107,90,10,1,C
211G,211G,15,2123,2146,23,90,10,1,C
211G,211G,15,2280,2325,45,90,10,1,C
211G,211G,15,2381,2413,32,90,10,1,C
211G,211G,15,2421,2445,24,90,10,1,C
211G,211G,15,2484,2503,19,90,10,1,C
211G,211G,15,2535,2573,38,90,10,1,C
211G,211G,15,2590,2606,16,90,10,1,C
211G,211G,15,2612,2631,19,90,10,1,C
211G,211G,15,2758,2788,30,90,10,1,C
211G,211G,15,2861,2920,59,90,10,1,C
211G,211G,15,2926,2949,23,90,10,1,C
211G,211G,15,2955,2982,27,90,10,1,C
211G,211G,28,668,698,30,90,10,1,C
211G,211G,28,760,878,118,90,10,1,C
211G,211G,28,924,943,19,90,10,1,C
211G,211G,28,1049,1087,38,90,10,1,C
211G,211G,28,1131,1249,118,90,10,1,C
211G,211G,28,1365,1430,65,90,10,1,C
211G,211G,28,1444,1468,24,90,10,1,C
211G,211G,28,1474,1490,16,90,10,1,C
211G,211G,28,1517,1573,56,90,10,1,C
211G,211G,28,1622,1638,16,90,10,1,C
211G,211G,28,1651,1683,32,90,10,1,C
211G,211G,28,1840,1885,45,90,10,1,C
211G,211G,28,1895,2089,194,90,10,1,C
211G,211G,28,2137,2175,38,90,10,1,C
211G,211G,28,2370,2389,19,90,10,1,C
211G,211G,28,2458,2480,22,90,10,1,C
211G,211G,28,2511,2532,21,90,10,1,C
211G,211G,28,2570,2585,15,90,10,1,C
211G,211G,28,2612,2630,18,90,10,1,C
211G,211G,28,2680,2709,29,90,10,1,C
211G,211G,28,2790,2812,22,90,10,1,C
211G,211G,28,2931,2970,39,90,10,1,C
212A,212A,2,0,34,34,90,10,1,C
212A,212A,2,56,401,345,90,10,1,C
212A,212A,2,438,566,128,90,10,1,C
212A,212A,2,574,600,26,90,10,1,C
212A,212A,2,610,658,48,90,10,1,C
212A,212A,2,680,752,72,90,10,1,C
212A,212A,2,778,825,47,90,10,1,C
212A,212A,2,846,880,34,90,10,1,C
212A,212A,2,887,941,54,90,10,1,C
212A,212A,2,960,1030,70,90,10,1,C
212A,212A,2,1045,1070,25,90,10,1,C
212A,212A,2,1110,1126,16,90,10,1,C
212A,212A,2,1166,1229,63,90,10,1,C
212A,212A,2,1240,1365,125,90,10,1,C
212A,212A,2,1374,1436,62,90,10,1,C
212A,212A,2,1450,1470,20,90,10,1,C
212A,212A,2,1479,1545,66,90,10,1,C
212A,212A,2,1589,1606,17,90,10,1,C
212A,212A,2,1677,1707,30,90,10,1,C
212A,212A,2,1718,1731,13,90,10,1,C
212A,212A,2,1746,1865,119,90,10,1,C
212A,212A,2,1875,1889,14,90,10,1,C
212A,212A,2,1894,1946,52,90,10,1,C
212A,212A,2,1971,2009,38,90,10,1,C
212A,212A,2,2031,2089,58,90,10,1,C
212A,212A,2,2125,2205,80,90,10,1,C
212A,212A,2,2282,2298,16,90,10,1,C
212A,212A,2,2329,2340,11,90,10,1,C
212A,212A,2,2373,2505,132,90,10,1,C
212A,212A,2,2511,2569,58,90,10,1,C
212A,212A,2,2613,2660,47,90,10,1,C
212A,212A,2,2674,2707,33,90,10,1,C
212A,212A,2,2721,2724,3,90,10,1,C
212A,212A,2,2768,2782,14,90,10,1,C
212A,212A,2,2801,2851,50,90,10,1,C
212A,212A,2,2867,2905,38,90,10,1,C
212A,212A,2,2920,2941,21,90,10,1,C
212A,212A,15,55,77,22,90,10,1,C
212A,212A,15,107,130,23,90,10,1,C
212A,212A,15,150,181,31,90,10,1,C
212A,212A,15,195,241,46,90,10,1,C
212A,212A,15,262,330,68,90,10,1,C
212A,212A,15,339,430,91,90,10,1,C
212A,212A,15,449,518,69,90,10,1,C
212A,212A,15,610,628,18,90,10,1,C
212A,212A,15,654,733,79,90,10,1,C
212A,212A,15,784,881,97,90,10,1,C
212A,212A,15,892,1001,109,90,10,1,C
212A,212A,15,1007,1028,21,90,10,1,C
212A,212A,15,1033,1066,33,90,10,1,C
212A,212A,15,1120,1131,11,90,10,1,C
212A,212A,15,1137,1185,48,90,10,1,C
212A,212A,15,1208,1230,22,90,10,1,C
212A,212A,15,1261,1274,13,90,10,1,C
212A,212A,15,1279,1455,176,90,10,1,C
212A,212A,15,1504,1565,61,90,10,1,C
212A,212A,15,1610,1620,10,90,10,1,C
212A,212A,15,1630,1729,99,90,10,1,C
212A,212A,15,1748,1829,81,90,10,1,C
212A,212A,15,1842,2098,256,90,10,1,C
212A,212A,15,2123,2174,51,90,10,1,C
212A,212A,15,2190,2252,62,90,10,1,C
212A,212A,15,2293,2311,18,90,10,1,C
212A,212A,15,2348,2375,27,90,10,1,C
212A,212A,15,2386,2444,58,90,10,1,C
212A,212A,15,2458,2481,23,90,10,1,C
212A,212A,15,2491,2616,125,90,10,1,C
212A,212A,15,2652,2733,81,90,10,1,C
212A,212A,15,2753,2770,17,90,10,1,C
212A,212A,15,2822,2931,109,90,10,1,C
212A,212A,28,120,170,50,90,10,1,C
212A,212A,28,190,201,11,90,10,1,C
212A,212A,28,215,252,37,90,10,1,C
212A,212A,28,267,303,36,90,10,1,C
212A,212A,28,327,362,35,90,10,1,C
212A,212A,28,375,396,21,90,10,1,C
212A,212A,28,406,543,137,90,10,1,C
212A,212A,28,550,561,11,90,10,1,C
212A,212A,28,566,596,30,90,10,1,C
212A,212A,28,723,771,48,90,10,1,C
212A,212A,28,787,802,15,90,10,1,C
212A,212A,28,816,849,33,90,10,1,C
212A,212A,28,880,971,91,90,10,1,C
212A,212A,28,978,996,18,90,10,1,C
212A,212A,28,1007,1026,19,90,10,1,C
212A,212A,28,1035,1054,19,90,10,1,C
212A,212A,28,1101,1120,19,90,10,1,C
212A,212A,28,1141,1216,75,90,10,1,C
212A,212A,28,1487,1510,23,90,10,1,C
212A,212A,28,1525,1546,21,90,10,1,C
212A,212A,28,1560,1580,20,90,10,1,C
212A,212A,28,1614,1645,31,90,10,1,C
212A,212A,28,1755,1771,16,90,10,1,C
212A,212A,28,1834,1875,41,90,10,1,C
212A,212A,28,1896,1923,27,90,10,1,C
212A,212A,28,2020,2042,22,90,10,1,C
212A,212A,28,2121,2164,43,90,10,1,C
212A,212A,28,2417,2471,54,90,10,1,C
212A,212A,28,2540,2558,18,90,10,1,C
212A,212A,28,2650,2723,73,90,10,1,C
212A,212A,28,2735,2806,71,90,10,1,C
212A,212A,28,2855,2885,30,90,10,1,C
212A,212A,28,2891,3000,109,90,10,1,C
212G,212G,2,11,122,111,90,10,1,C
212G,212G,2,264,274,10,90,10,1,C
212G,212G,2,766,888,122,90,10,1,C
212G,212G,2,910,946,36,90,10,1,C
212G,212G,2,1000,1021,21,90,10,1,C
212G,212G,2,1100,1122,22,90,10,1,C
212G,212G,2,1156,1172,16,90,10,1,C
212G,212G,2,1255,1280,25,90,10,1,C
212G,212G,2,1289,1326,37,90,10,1,C
212G,212G,2,1381,1513,132,90,10,1,C
212G,212G,2,1535,1557,22,90,10,1,C
212G,212G,2,1632,1679,47,90,10,1,C
212G,212G,2,1785,1804,19,90,10,1,C
212G,212G,2,1946,1963,17,90,10,1,C
212G,212G,2,2008,2081,73,90,10,1,C
212G,212G,2,2317,2340,23,90,10,1,C
212G,212G,2,2356,2383,27,90,10,1,C
212G,212G,2,2570,2612,42,90,10,1,C
212G,212G,2,2618,2651,33,90,10,1,C
212G,212G,2,2673,2690,17,90,10,1,C
212G,212G,2,2727,2750,23,90,10,1,C
212G,212G,2,2762,2784,22,90,10,1,C
212G,212G,2,2822,2864,42,90,10,1,C
212G,212G,2,2890,2905,15,90,10,1,C
212G,212G,2,2969,2990,21,90,10,1,C
212G,212G,15,2,98,96,90,10,1,C
212G,212G,15,120,195,75,90,10,1,C
212G,212G,15,212,267,55,90,10,1,C
212G,212G,15,300,315,15,90,10,1,C
212G,212G,15,359,536,177,90,10,1,C
212G,212G,15,557,584,27,90,10,1,C
212G,212G,15,608,638,30,90,10,1,C
212G,212G,15,682,710,28,90,10,1,C
212G,212G,15,835,849,14,90,10,1,C
212G,212G,15,945,1077,132,90,10,1,C
212G,212G,15,1087,1101,14,90,10,1,C
212G,212G,15,1196,1209,13,90,10,1,C
212G,212G,15,1214,1242,28,90,10,1,C
212G,212G,15,1283,1330,47,90,10,1,C
212G,212G,15,1364,1388,24,90,10,1,C
212G,212G,15,1435,1447,12,90,10,1,C
212G,212G,15,1475,1518,43,90,10,1,C
212G,212G,15,1561,1583,22,90,10,1,C
212G,212G,15,1605,1626,21,90,10,1,C
212G,212G,15,1702,1723,21,90,10,1,C
212G,212G,15,1791,1850,59,90,10,1,C
212G,212G,15,1852,1982,130,90,10,1,C
212G,212G,15,1998,2013,15,90,10,1,C
212G,212G,15,2045,2097,52,90,10,1,C
212G,212G,15,2128,2174,46,90,10,1,C
212G,212G,15,2181,2192,11,90,10,1,C
212G,212G,15,2226,2243,17,90,10,1,C
212G,212G,15,2314,2359,45,90,10,1,C
212G,212G,15,2421,2441,20,90,10,1,C
212G,212G,15,2486,2515,29,90,10,1,C
212G,212G,15,2622,2747,125,90,10,1,C
212G,212G,15,2753,2913,160,90,10,1,C
212G,212G,15,2926,2986,60,90,10,1,C
212G,212G,28,43,63,20,90,10,1,C
212G,212G,28,210,232,22,90,10,1,C
212G,212G,28,257,289,32,90,10,1,C
212G,212G,28,323,420,97,90,10,1,C
212G,212G,28,454,471,17,90,10,1,C
212G,212G,28,585,608,23,90,10,1,C
212G,212G,28,622,660,38,90,10,1,C
212G,212G,28,670,690,20,90,10,1,C
212G,212G,28,700,759,59,90,10,1,C
212G,212G,28,824,861,37,90,10,1,C
212G,212G,28,891,933,42,90,10,1,C
212G,212G,28,985,1038,53,90,10,1,C
212G,212G,28,1055,1242,187,90,10,1,C
212G,212G,28,1254,1289,35,90,10,1,C
212G,212G,28,1350,1379,29,90,10,1,C
212G,212G,28,1448,1549,101,90,10,1,C
212G,212G,28,1555,1585,30,90,10,1,C
212G,212G,28,1643,1702,59,90,10,1,C
212G,212G,28,1714,1861,147,90,10,1,C
212G,212G,28,1885,1920,35,90,10,1,C
212G,212G,28,1931,1972,41,90,10,1,C
212G,212G,28,2011,2168,157,90,10,1,C
212G,212G,28,2220,2251,31,90,10,1,C
212G,212G,28,2272,2300,28,90,10,1,C
212G,212G,28,2321,2344,23,90,10,1,C
212G,212G,28,2351,2385,34,90,10,1,C
212G,212G,28,2416,2483,67,90,10,1,C
212G,212G,28,2489,2500,11,90,10,1,C
212G,212G,28,2505,2515,10,90,10,1,C
212G,212G,28,2545,2560,15,90,10,1,C
212G,212G,28,2582,2609,27,90,10,1,C
212G,212G,28,2620,2662,42,90,10,1,C
212G,212G,28,2752,2793,41,90,10,1,C
212G,212G,28,2802,2813,11,90,10,1,C
212G,212G,28,2838,2879,41,90,10,1,C
212G,212G,28,2891,2908,17,90,10,1,C
212G,212G,28,2929,3000,71,90,10,1,C
213A,213A,2,108,125,17,90,10,1,C
213A,213A,2,134,150,16,90,10,1,C
213A,213A,2,280,318,38,90,10,1,C
213A,213A,2,371,416,45,90,10,1,C
213A,213A,2,458,510,52,90,10,1,C
213A,213A,2,540,556,16,90,10,1,C
213A,213A,2,561,573,12,90,10,1,C
213A,213A,2,655,693,38,90,10,1,C
213A,213A,2,712,736,24,90,10,1,C
213A,213A,2,746,829,83,90,10,1,C
213A,213A,2,839,850,11,90,10,1,C
213A,213A,2,878,895,17,90,10,1,C
213A,213A,2,900,913,13,90,10,1,C
213A,213A,2,920,948,28,90,10,1,C
213A,213A,2,1011,1023,12,90,10,1,C
213A,213A,2,1030,1043,13,90,10,1,C
213A,213A,2,1065,1131,66,90,10,1,C
213A,213A,2,1155,1214,59,90,10,1,C
213A,213A,2,1295,1371,76,90,10,1,C
213A,213A,2,1380,1391,11,90,10,1,C
213A,213A,2,1449,1489,40,90,10,1,C
213A,213A,2,1555,1590,35,90,10,1,C
213A,213A,2,1714,1730,16,90,10,1,C
213A,213A,2,1801,1842,41,90,10,1,C
213A,213A,2,1854,1882,28,90,10,1,C
213A,213A,2,1941,1960,19,90,10,1,C
213A,213A,2,2048,2071,23,90,10,1,C
213A,213A,2,2077,2101,24,90,10,1,C
213A,213A,2,2110,2155,45,90,10,1,C
213A,213A,2,2280,2308,28,90,10,1,C
213A,213A,2,2368,2431,63,90,10,1,C
213A,213A,2,2440,2452,12,90,10,1,C
213A,213A,2,2540,2562,22,90,10,1,C
213A,213A,2,2588,2626,38,90,10,1,C
213A,213A,2,2681,2726,45,90,10,1,C
213A,213A,2,2864,2887,23,90,10,1,C
213A,213A,2,2912,2933,21,90,10,1,C
213A,213A,2,2938,2951,13,90,10,1,C
213A,213A,15,54,109,55,90,10,1,C
213A,213A,15,128,169,41,90,10,1,C
213A,213A,15,206,233,27,90,10,1,C
213A,213A,15,358,441,83,90,10,1,C
213A,213A,15,499,608,109,90,10,1,C
213A,213A,15,659,691,32,90,10,1,C
213A,213A,15,716,769,53,90,10,1,C
213A,213A,15,774,785,11,90,10,1,C
213A,213A,15,869,909,40,90,10,1,C
213A,213A,15,938,989,51,90,10,1,C
213A,213A,15,1026,1049,23,90,10,1,C
213A,213A,15,1056,1104,48,90,10,1,C
213A,213A,15,1140,1184,44,90,10,1,C
213A,213A,15,1193,1222,29,90,10,1,C
213A,213A,15,1244,1265,21,90,10,1,C
213A,213A,15,1273,1310,37,90,10,1,C
213A,213A,15,1319,1378,59,90,10,1,C
213A,213A,15,1442,1473,31,90,10,1,C
213A,213A,15,1496,1539,43,90,10,1,C
213A,213A,15,1560,1587,27,90,10,1,C
213A,213A,15,1593,1671,78,90,10,1,C
213A,213A,15,1697,1709,12,90,10,1,C
213A,213A,15,1714,1742,28,90,10,1,C
213A,213A,15,1775,1951,176,90,10,1,C
213A,213A,15,2004,2042,38,90,10,1,C
213A,213A,15,2058,2105,47,90,10,1,C
213A,213A,15,2116,2148,32,90,10,1,C
213A,213A,15,2178,2212,34,90,10,1,C
213A,213A,15,2353,2380,27,90,10,1,C
213A,213A,15,2393,2448,55,90,10,1,C
213A,213A,15,2493,2528,35,90,10,1,C
213A,213A,15,2578,2645,67,90,10,1,C
213A,213A,15,2655,2718,63,90,10,1,C
213A,213A,15,2763,2790,27,90,10,1,C
213A,213A,15,2843,2866,23,90,10,1,C
213A,213A,15,2895,2970,75,90,10,1,C
213A,213A,28,9,41,32,90,10,1,C
213A,213A,28,154,172,18,90,10,1,C
213A,213A,28,183,204,21,90,10,1,C
213A,213A,28,289,355,66,90,10,1,C
213A,213A,28,378,409,31,90,10,1,C
213A,213A,28,427,456,29,90,10,1,C
213A,213A,28,461,508,47,90,10,1,C
213A,213A,28,562,661,99,90,10,1,C
213A,213A,28,681,733,52,90,10,1,C
213A,213A,28,781,813,32,90,10,1,C
213A,213A,28,846,868,22,90,10,1,C
213A,213A,28,912,962,50,90,10,1,C
213A,213A,28,979,1013,34,90,10,1,C
213A,213A,28,1023,1078,55,90,10,1,C
213A,213A,28,1249,1298,49,90,10,1,C
213A,213A,28,1354,1393,39,90,10,1,C
213A,213A,28,1473,1498,25,90,10,1,C
213A,213A,28,1506,1558,52,90,10,1,C
213A,213A,28,1565,1595,30,90,10,1,C
213A,213A,28,1700,1722,22,90,10,1,C
213A,213A,28,1765,1863,98,90,10,1,C
213A,213A,28,1904,1967,63,90,10,1,C
213A,213A,28,1990,2008,18,90,10,1,C
213A,213A,28,2026,2052,26,90,10,1,C
213A,213A,28,2089,2104,15,90,10,1,C
213A,213A,28,2124,2150,26,90,10,1,C
213A,213A,28,2348,2372,24,90,10,1,C
213A,213A,28,2414,2468,54,90,10,1,C
213A,213A,28,2510,2575,65,90,10,1,C
213A,213A,28,2590,2667,77,90,10,1,C
213A,213A,28,2759,2770,11,90,10,1,C
213A,213A,28,2777,2849,72,90,10,1,C
213A,213A,28,2858,2888,30,90,10,1,C
213A,213A,28,2939,2966,27,90,10,1,C
213A,213A,28,2973,2995,22,90,10,1,C
213G,213G,2,118,155,37,90,10,1,C
213G,213G,2,217,245,28,90,10,1,C
213G,213G,2,300,315,15,90,10,1,C
213G,213G,2,329,340,11,90,10,1,C
213G,213G,2,388,420,32,90,10,1,C
213G,213G,2,447,467,20,90,10,1,C
213G,213G,2,519,536,17,90,10,1,C
213G,213G,2,768,780,12,90,10,1,C
213G,213G,2,983,1000,17,90,10,1,C
213G,213G,2,1137,1163,26,90,10,1,C
213G,213G,2,1212,1225,13,90,10,1,C
213G,213G,2,1238,1261,23,90,10,1,C
213G,213G,2,1293,1327,34,90,10,1,C
213G,213G,2,1346,1357,11,90,10,1,C
213G,213G,2,1408,1424,16,90,10,1,C
213G,213G,2,1439,1451,12,90,10,1,C
213G,213G,2,1550,1571,21,90,10,1,C
213G,213G,2,1582,1627,45,90,10,1,C
213G,213G,2,1643,1720,77,90,10,1,C
213G,213G,2,1769,1810,41,90,10,1,C
213G,213G,2,1815,1829,14,90,10,1,C
213G,213G,2,1849,1872,23,90,10,1,C
213G,213G,2,1927,1974,47,90,10,1,C
213G,213G,2,2031,2055,24,90,10,1,C
213G,213G,2,2071,2081,10,90,10,1,C
213G,213G,2,2110,2128,18,90,10,1,C
213G,213G,2,2143,2178,35,90,10,1,C
213G,213G,2,2190,2213,23,90,10,1,C
213G,213G,2,2262,2309,47,90,10,1,C
213G,213G,2,2335,2370,35,90,10,1,C
213G,213G,2,2393,2404,11,90,10,1,C
213G,213G,2,2517,2548,31,90,10,1,C
213G,213G,2,2579,2591,12,90,10,1,C
213G,213G,2,2598,2618,20,90,10,1,C
213G,213G,2,2660,2692,32,90,10,1,C
213G,213G,2,2771,2793,22,90,10,1,C
213G,213G,2,2816,2841,25,90,10,1,C
213G,213G,15,193,216,23,90,10,1,C
213G,213G,15,244,300,56,90,10,1,C
213G,213G,15,335,357,22,90,10,1,C
213G,213G,15,489,502,13,90,10,1,C
213G,213G,15,510,536,26,90,10,1,C
213G,213G,15,578,605,27,90,10,1,C
213G,213G,15,612,641,29,90,10,1,C
213G,213G,15,650,666,16,90,10,1,C
213G,213G,15,674,753,79,90,10,1,C
213G,213G,15,765,785,20,90,10,1,C
213G,213G,15,797,860,63,90,10,1,C
213G,213G,15,871,961,90,90,10,1,C
213G,213G,15,997,1030,33,90,10,1,C
213G,213G,15,1035,1045,10,90,10,1,C
213G,213G,15,1050,1080,30,90,10,1,C
213G,213G,15,1095,1140,45,90,10,1,C
213G,213G,15,1194,1267,73,90,10,1,C
213G,213G,15,1282,1368,86,90,10,1,C
213G,213G,15,1373,1443,70,90,10,1,C
213G,213G,15,1448,1476,28,90,10,1,C
213G,213G,15,1521,1551,30,90,10,1,C
213G,213G,15,1598,1647,49,90,10,1,C
213G,213G,15,1657,1751,94,90,10,1,C
213G,213G,15,1756,1771,15,90,10,1,C
213G,213G,15,1779,1792,13,90,10,1,C
213G,213G,15,1820,1848,28,90,10,1,C
213G,213G,15,1860,2012,152,90,10,1,C
213G,213G,15,2046,2065,19,90,10,1,C
213G,213G,15,2100,2125,25,90,10,1,C
213G,213G,15,2132,2143,11,90,10,1,C
213G,213G,15,2158,2171,13,90,10,1,C
213G,213G,15,2176,2186,10,90,10,1,C
213G,213G,15,2202,2215,13,90,10,1,C
213G,213G,15,2243,2256,13,90,10,1,C
213G,213G,15,2278,2356,78,90,10,1,C
213G,213G,15,2398,2420,22,90,10,1,C
213G,213G,15,2444,2472,28,90,10,1,C
213G,213G,15,2502,2579,77,90,10,1,C
213G,213G,15,2592,2604,12,90,10,1,C
213G,213G,15,2647,2662,15,90,10,1,C
213G,213G,15,2667,2695,28,90,10,1,C
213G,213G,15,2720,2751,31,90,10,1,C
213G,213G,15,2773,2792,19,90,10,1,C
213G,213G,15,2818,2833,15,90,10,1,C
213G,213G,15,2901,2931,30,90,10,1,C
213G,213G,15,2938,2948,10,90,10,1,C
213G,213G,15,2980,2995,15,90,10,1,C
213G,213G,28,127,142,15,90,10,1,C
213G,213G,28,159,180,21,90,10,1,C
213G,213G,28,206,251,45,90,10,1,C
213G,213G,28,286,305,19,90,10,1,C
213G,213G,28,325,340,15,90,10,1,C
213G,213G,28,400,445,45,90,10,1,C
213G,213G,28,468,483,15,90,10,1,C
213G,213G,28,520,548,28,90,10,1,C
213G,213G,28,619,651,32,90,10,1,C
213G,213G,28,845,858,13,90,10,1,C
213G,213G,28,869,885,16,90,10,1,C
213G,213G,28,945,984,39,90,10,1,C
213G,213G,28,1009,1022,13,90,10,1,C
213G,213G,28,1078,1090,12,90,10,1,C
213G,213G,28,1098,1113,15,90,10,1,C
213G,213G,28,1119,1134,15,90,10,1,C
213G,213G,28,1160,1187,27,90,10,1,C
213G,213G,28,1195,1206,11,90,10,1,C
213G,213G,28,1212,1222,10,90,10,1,C
213G,213G,28,1227,1319,92,90,10,1,C
213G,213G,28,1326,1380,54,90,10,1,C
213G,213G,28,1432,1457,25,90,10,1,C
213G,213G,28,1471,1493,22,90,10,1,C
213G,213G,28,1556,1576,20,90,10,1,C
213G,213G,28,1816,1831,15,90,10,1,C
213G,213G,28,1845,1857,12,90,10,1,C
213G,213G,28,1936,1948,12,90,10,1,C
213G,213G,28,1955,1978,23,90,10,1,C
213G,213G,28,2040,2055,15,90,10,1,C
213G,213G,28,2101,2139,38,90,10,1,C
213G,213G,28,2148,2191,43,90,10,1,C
213G,213G,28,2208,2223,15,90,10,1,C
213G,213G,28,2230,2242,12,90,10,1,C
213G,213G,28,2249,2270,21,90,10,1,C
213G,213G,28,2300,2326,26,90,10,1,C
213G,213G,28,2385,2408,23,90,10,1,C
213G,213G,28,2416,2519,103,90,10,1,C
213G,213G,28,2535,2573,38,90,10,1,C
213G,213G,28,2580,2594,14,90,10,1,C
213G,213G,28,2602,2638,36,90,10,1,C
213G,213G,28,2665,2684,19,90,10,1,C
213G,213G,28,2690,2718,28,90,10,1,C
213G,213G,28,2775,2818,43,90,10,1,C
213G,213G,28,2864,2885,21,90,10,1,C
213G,213G,28,2937,2956,19,90,10,1,C
213G,213G,28,2962,2990,28,90,10,1,C
214A,214A,2,8,20,12,90,10,1,C
214A,214A,2,85,115,30,90,10,1,C
214A,214A,2,136,154,18,90,10,1,C
214A,214A,2,160,202,42,90,10,1,C
214A,214A,2,237,250,13,90,10,1,C
214A,214A,2,358,371,13,90,10,1,C
214A,214A,2,389,405,16,90,10,1,C
214A,214A,2,439,450,11,90,10,1,C
214A,214A,2,479,492,13,90,10,1,C
214A,214A,2,577,612,35,90,10,1,C
214A,214A,2,639,665,26,90,10,1,C
214A,214A,2,695,738,43,90,10,1,C
214A,214A,2,750,764,14,90,10,1,C
214A,214A,2,793,834,41,90,10,1,C
214A,214A,2,868,916,48,90,10,1,C
214A,214A,2,938,968,30,90,10,1,C
214A,214A,2,1632,1644,12,90,10,1,C
214A,214A,2,1940,1988,48,90,10,1,C
214A,214A,2,2015,2033,18,90,10,1,C
214A,214A,2,2124,2166,42,90,10,1,C
214A,214A,2,2272,2310,38,90,10,1,C
214A,214A,2,2351,2389,38,90,10,1,C
214A,214A,2,2421,2444,23,90,10,1,C
214A,214A,2,2467,2486,19,90,10,1,C
214A,214A,2,2580,2605,25,90,10,1,C
214A,214A,2,2735,2783,48,90,10,1,C
214A,214A,2,2801,2819,18,90,10,1,C
214A,214A,2,2845,2985,140,90,10,1,C
214A,214A,15,0,111,111,90,10,1,C
214A,214A,15,15,92,77,90,10,1,C
214A,214A,15,282,292,10,90,10,1,C
214A,214A,15,475,500,25,90,10,1,C
214A,214A,15,517,534,17,90,10,1,C
214A,214A,15,602,632,30,90,10,1,C
214A,214A,15,653,715,62,90,10,1,C
214A,214A,15,754,808,54,90,10,1,C
214A,214A,15,833,850,17,90,10,1,C
214A,214A,15,972,1017,45,90,10,1,C
214A,214A,15,1049,1090,41,90,10,1,C
214A,214A,15,1179,1225,46,90,10,1,C
214A,214A,15,1248,1297,49,90,10,1,C
214A,214A,15,1351,1365,14,90,10,1,C
214A,214A,15,1390,1414,24,90,10,1,C
214A,214A,15,1435,1456,21,90,10,1,C
214A,214A,15,1549,1572,23,90,10,1,C
214A,214A,15,1594,1647,53,90,10,1,C
214A,214A,15,1709,1759,50,90,10,1,C
214A,214A,15,1829,1851,22,90,10,1,C
214A,214A,15,1868,1882,14,90,10,1,C
214A,214A,15,1893,1910,17,90,10,1,C
214A,214A,15,1961,1980,19,90,10,1,C
214A,214A,15,2048,2061,13,90,10,1,C
214A,214A,15,2082,2121,39,90,10,1,C
214A,214A,15,2246,2279,33,90,10,1,C
214A,214A,15,2324,2360,36,90,10,1,C
214A,214A,15,2420,2435,15,90,10,1,C
214A,214A,15,2441,2454,13,90,10,1,C
214A,214A,15,2485,2537,52,90,10,1,C
214A,214A,15,2571,2606,35,90,10,1,C
214A,214A,15,2657,2688,31,90,10,1,C
214A,214A,15,2738,2752,14,90,10,1,C
214A,214A,28,130,205,75,90,10,1,C
214A,214A,28,261,302,41,90,10,1,C
214A,214A,28,353,444,91,90,10,1,C
214A,214A,28,473,540,67,90,10,1,C
214A,214A,28,615,728,113,90,10,1,C
214A,214A,28,741,788,47,90,10,1,C
214A,214A,28,869,929,60,90,10,1,C
214A,214A,28,939,961,22,90,10,1,C
214A,214A,28,1046,1100,54,90,10,1,C
214A,214A,28,1147,1160,13,90,10,1,C
214A,214A,28,1308,1336,28,90,10,1,C
214A,214A,28,1359,1384,25,90,10,1,C
214A,214A,28,1404,1416,12,90,10,1,C
214A,214A,28,1421,1482,61,90,10,1,C
214A,214A,28,1514,1532,18,90,10,1,C
214A,214A,28,1978,2000,22,90,10,1,C
214A,214A,28,2010,2020,10,90,10,1,C
214A,214A,28,2025,2061,36,90,10,1,C
214A,214A,28,2112,2142,30,90,10,1,C
214A,214A,28,2212,2284,72,90,10,1,C
214A,214A,28,2291,2303,12,90,10,1,C
214A,214A,28,2346,2363,17,90,10,1,C
214A,214A,28,2414,2440,26,90,10,1,C
214A,214A,28,2538,2550,12,90,10,1,C
214A,214A,28,2555,2568,13,90,10,1,C
214A,214A,28,2596,2610,14,90,10,1,C
214A,214A,28,2664,2684,20,90,10,1,C
214A,214A,28,2708,2733,25,90,10,1,C
214A,214A,28,2868,2900,32,90,10,1,C
214A,214A,28,2935,2980,45,90,10,1,C
214A,214A,28,2990,3000,10,90,10,1,C
214G,214G,2,20,48,28,90,10,1,C
214G,214G,2,65,98,33,90,10,1,C
214G,214G,2,112,127,15,90,10,1,C
214G,214G,2,133,159,26,90,10,1,C
214G,214G,2,235,430,195,90,10,1,C
214G,214G,2,435,486,51,90,10,1,C
214G,214G,2,498,512,14,90,10,1,C
214G,214G,2,557,626,69,90,10,1,C
214G,214G,2,636,646,10,90,10,1,C
214G,214G,2,651,681,30,90,10,1,C
214G,214G,2,699,728,29,90,10,1,C
214G,214G,2,768,788,20,90,10,1,C
214G,214G,2,795,834,39,90,10,1,C
214G,214G,2,851,916,65,90,10,1,C
214G,214G,2,953,993,40,90,10,1,C
214G,214G,2,1013,1030,17,90,10,1,C
214G,214G,2,1039,1062,23,90,10,1,C
214G,214G,2,1227,1253,26,90,10,1,C
214G,214G,2,1263,1287,24,90,10,1,C
214G,214G,2,1330,1345,15,90,10,1,C
214G,214G,2,1456,1478,22,90,10,1,C
214G,214G,2,1532,1551,19,90,10,1,C
214G,214G,2,1596,1613,17,90,10,1,C
214G,214G,2,1638,1652,14,90,10,1,C
214G,214G,2,1664,1685,21,90,10,1,C
214G,214G,2,1695,1725,30,90,10,1,C
214G,214G,2,1797,1856,59,90,10,1,C
214G,214G,2,1897,1907,10,90,10,1,C
214G,214G,2,1975,1994,19,90,10,1,C
214G,214G,2,2003,2169,166,90,10,1,C
214G,214G,2,2187,2266,79,90,10,1,C
214G,214G,2,2293,2317,24,90,10,1,C
214G,214G,2,2331,2481,150,90,10,1,C
214G,214G,2,2523,2536,13,90,10,1,C
214G,214G,2,2566,2585,19,90,10,1,C
214G,214G,15,0,10,10,90,10,1,C
214G,214G,15,61,167,106,90,10,1,C
214G,214G,15,206,273,67,90,10,1,C
214G,214G,15,309,322,13,90,10,1,C
214G,214G,15,578,608,30,90,10,1,C
214G,214G,15,824,918,94,90,10,1,C
214G,214G,15,927,963,36,90,10,1,C
214G,214G,15,1012,1037,25,90,10,1,C
214G,214G,15,1149,1176,27,90,10,1,C
214G,214G,15,1228,1287,59,90,10,1,C
214G,214G,15,1319,1356,37,90,10,1,C
214G,214G,15,1377,1413,36,90,10,1,C
214G,214G,15,1454,1471,17,90,10,1,C
214G,214G,15,1585,1613,28,90,10,1,C
214G,214G,15,1689,1719,30,90,10,1,C
214G,214G,15,1911,1945,34,90,10,1,C
214G,214G,15,1957,1969,12,90,10,1,C
214G,214G,15,1980,2002,22,90,10,1,C
214G,214G,15,2022,2067,45,90,10,1,C
214G,214G,15,2076,2099,23,90,10,1,C
214G,214G,15,2118,2184,66,90,10,1,C
214G,214G,15,2357,2372,15,90,10,1,C
214G,214G,15,2382,2395,13,90,10,1,C
214G,214G,15,2410,2431,21,90,10,1,C
214G,214G,15,2507,2523,16,90,10,1,C
214G,214G,15,2535,2574,39,90,10,1,C
214G,214G,15,2675,2700,25,90,10,1,C
214G,214G,15,2773,2797,24,90,10,1,C
214G,214G,15,2808,2837,29,90,10,1,C
214G,214G,15,2852,2921,69,90,10,1,C
214G,214G,15,2927,2988,61,90,10,1,C
214G,214G,28,15,48,33,90,10,1,C
214G,214G,28,104,129,25,90,10,1,C
214G,214G,28,221,236,15,90,10,1,C
214G,214G,28,288,308,20,90,10,1,C
214G,214G,28,336,347,11,90,10,1,C
214G,214G,28,355,370,15,90,10,1,C
214G,214G,28,375,394,19,90,10,1,C
214G,214G,28,399,418,19,90,10,1,C
214G,214G,28,439,478,39,90,10,1,C
214G,214G,28,588,607,19,90,10,1,C
214G,214G,28,661,695,34,90,10,1,C
214G,214G,28,778,789,11,90,10,1,C
214G,214G,28,1042,1056,14,90,10,1,C
214G,214G,28,1072,1093,21,90,10,1,C
214G,214G,28,1103,1114,11,90,10,1,C
214G,214G,28,1162,1172,10,90,10,1,C
214G,214G,28,1213,1264,51,90,10,1,C
214G,214G,28,1282,1368,86,90,10,1,C
214G,214G,28,1391,1415,24,90,10,1,C
214G,214G,28,1445,1477,32,90,10,1,C
214G,214G,28,1486,1527,41,90,10,1,C
214G,214G,28,1532,1551,19,90,10,1,C
214G,214G,28,1560,1580,20,90,10,1,C
214G,214G,28,1593,1621,28,90,10,1,C
214G,214G,28,1626,1657,31,90,10,1,C
214G,214G,28,1720,1740,20,90,10,1,C
214G,214G,28,1751,1778,27,90,10,1,C
214G,214G,28,1784,1798,14,90,10,1,C
214G,214G,28,1808,1820,12,90,10,1,C
214G,214G,28,1895,1945,50,90,10,1,C
214G,214G,28,1956,1992,36,90,10,1,C
214G,214G,28,2012,2030,18,90,10,1,C
214G,214G,28,2043,2068,25,90,10,1,C
214G,214G,28,2073,2087,14,90,10,1,C
214G,214G,28,2100,2126,26,90,10,1,C
214G,214G,28,2158,2192,34,90,10,1,C
214G,214G,28,2225,2260,35,90,10,1,C
214G,214G,28,2298,2317,19,90,10,1,C
214G,214G,28,2413,2452,39,90,10,1,C
214G,214G,28,2496,2507,11,90,10,1,C
214G,214G,28,2536,2552,16,90,10,1,C
214G,214G,28,2559,2638,79,90,10,1,C
214G,214G,28,2673,2719,46,90,10,1,C
214G,214G,28,2751,2809,58,90,10,1,C
214G,214G,28,2836,2864,28,90,10,1,C
214G,214G,28,2898,2945,47,90,10,1,C
215A,215A,2,0,11,11,90,10,1,C
215A,215A,2,18,44,26,90,10,1,C
215A,215A,2,53,68,15,90,10,1,C
215A,215A,2,258,279,21,90,10,1,C
215A,215A,2,401,414,13,90,10,1,C
215A,215A,2,511,549,38,90,10,1,C
215A,215A,2,639,683,44,90,10,1,C
215A,215A,2,700,716,16,90,10,1,C
215A,215A,2,721,739,18,90,10,1,C
215A,215A,2,746,771,25,90,10,1,C
215A,215A,2,811,891,80,90,10,1,C
215A,215A,2,896,910,14,90,10,1,C
215A,215A,2,916,953,37,90,10,1,C
215A,215A,2,970,1026,56,90,10,1,C
215A,215A,2,1057,1074,17,90,10,1,C
215A,215A,2,1160,1191,31,90,10,1,C
215A,215A,2,1275,1299,24,90,10,1,C
215A,215A,2,1305,1323,18,90,10,1,C
215A,215A,2,1331,1389,58,90,10,1,C
215A,215A,2,1685,1711,26,90,10,1,C
215A,215A,2,1770,1796,26,90,10,1,C
215A,215A,2,1807,1819,12,90,10,1,C
215A,215A,2,1827,1855,28,90,10,1,C
215A,215A,2,1861,1893,32,90,10,1,C
215A,215A,2,1910,1926,16,90,10,1,C
215A,215A,2,1956,1971,15,90,10,1,C
215A,215A,2,2055,2072,17,90,10,1,C
215A,215A,2,2079,2091,12,90,10,1,C
215A,215A,2,2128,2140,12,90,10,1,C
215A,215A,2,2146,2170,24,90,10,1,C
215A,215A,2,2267,2285,18,90,10,1,C
215A,215A,2,2307,2333,26,90,10,1,C
215A,215A,2,2339,2364,25,90,10,1,C
215A,215A,2,2441,2463,22,90,10,1,C
215A,215A,2,2542,2556,14,90,10,1,C
215A,215A,2,2595,2640,45,90,10,1,C
215A,215A,2,2645,2664,19,90,10,1,C
215A,215A,2,2683,2707,24,90,10,1,C
215A,215A,2,2742,2758,16,90,10,1,C
215A,215A,2,2830,2841,11,90,10,1,C
215A,215A,2,2847,2861,14,90,10,1,C
215A,215A,2,2866,2876,10,90,10,1,C
215A,215A,2,2892,3000,108,90,10,1,C
215A,215A,15,15,43,28,90,10,1,C
215A,215A,15,49,67,18,90,10,1,C
215A,215A,15,78,90,12,90,10,1,C
215A,215A,15,125,142,17,90,10,1,C
215A,215A,15,188,213,25,90,10,1,C
215A,215A,15,218,237,19,90,10,1,C
215A,215A,15,247,320,73,90,10,1,C
215A,215A,15,338,355,17,90,10,1,C
215A,215A,15,546,584,38,90,10,1,C
215A,215A,15,592,610,18,90,10,1,C
215A,215A,15,679,715,36,90,10,1,C
215A,215A,15,723,740,17,90,10,1,C
215A,215A,15,745,755,10,90,10,1,C
215A,215A,15,785,809,24,90,10,1,C
215A,215A,15,814,828,14,90,10,1,C
215A,215A,15,845,867,22,90,10,1,C
215A,215A,15,872,910,38,90,10,1,C
215A,215A,15,924,937,13,90,10,1,C
215A,215A,15,1013,1030,17,90,10,1,C
215A,215A,15,1089,1105,16,90,10,1,C
215A,215A,15,1215,1236,21,90,10,1,C
215A,215A,15,1260,1310,50,90,10,1,C
215A,215A,15,1327,1354,27,90,10,1,C
215A,215A,15,1377,1450,73,90,10,1,C
215A,215A,15,1498,1584,86,90,10,1,C
215A,215A,15,2119,2159,40,90,10,1,C
215A,215A,15,2211,2237,26,90,10,1,C
215A,215A,15,2251,2292,41,90,10,1,C
215A,215A,15,2334,2356,22,90,10,1,C
215A,215A,15,2385,2415,30,90,10,1,C
215A,215A,15,2440,2493,53,90,10,1,C
215A,215A,15,2587,2619,32,90,10,1,C
215A,215A,15,2624,2646,22,90,10,1,C
215A,215A,15,2723,2749,26,90,10,1,C
215A,215A,15,2756,2772,16,90,10,1,C
215A,215A,15,2793,2853,60,90,10,1,C
215A,215A,15,2874,2894,20,90,10,1,C
215A,215A,15,2900,2954,54,90,10,1,C
215A,215A,15,2970,3000,30,90,10,1,C
215A,215A,28,0,81,81,90,10,1,C
215A,215A,28,139,153,14,90,10,1,C
215A,215A,28,233,246,13,90,10,1,C
215A,215A,28,298,351,53,90,10,1,C
215A,215A,28,430,457,27,90,10,1,C
215A,215A,28,496,506,10,90,10,1,C
215A,215A,28,707,733,26,90,10,1,C
215A,215A,28,804,829,25,90,10,1,C
215A,215A,28,835,987,152,90,10,1,C
215A,215A,28,1015,1044,29,90,10,1,C
215A,215A,28,1209,1243,34,90,10,1,C
215A,215A,28,1325,1348,23,90,10,1,C
215A,215A,28,1427,1465,38,90,10,1,C
215A,215A,28,1500,1583,83,90,10,1,C
215A,215A,28,1599,1629,30,90,10,1,C
215A,215A,28,1679,1704,25,90,10,1,C
215A,215A,28,1755,1795,40,90,10,1,C
215A,215A,28,1815,1828,13,90,10,1,C
215A,215A,28,1910,1929,19,90,10,1,C
215A,215A,28,1961,1991,30,90,10,1,C
215A,215A,28,2056,2140,84,90,10,1,C
215A,215A,28,2162,2188,26,90,10,1,C
215A,215A,28,2196,2239,43,90,10,1,C
215A,215A,28,2259,2272,13,90,10,1,C
215A,215A,28,2305,2317,12,90,10,1,C
215A,215A,28,2338,2349,11,90,10,1,C
215A,215A,28,2371,2407,36,90,10,1,C
215A,215A,28,2437,2454,17,90,10,1,C
215A,215A,28,2515,2599,84,90,10,1,C
215A,215A,28,2609,2640,31,90,10,1,C
215A,215A,28,2716,2734,18,90,10,1,C
215A,215A,28,2776,2801,25,90,10,1,C
215A,215A,28,2806,2835,29,90,10,1,C
215A,215A,28,2844,2856,12,90,10,1,C
215A,215A,28,2868,2905,37,90,10,1,C
215A,215A,28,2910,2965,55,90,10,1,C
215A,215A,28,2974,2996,22,90,10,1,C
215G,215G,2,36,196,160,90,10,1,C
215G,215G,2,226,253,27,90,10,1,C
215G,215G,2,260,285,25,90,10,1,C
215G,215G,2,302,331,29,90,10,1,C
215G,215G,2,440,474,34,90,10,1,C
215G,215G,2,479,667,188,90,10,1,C
215G,215G,2,685,721,36,90,10,1,C
215G,215G,2,726,840,114,90,10,1,C
215G,215G,2,874,909,35,90,10,1,C
215G,215G,2,920,933,13,90,10,1,C
215G,215G,2,938,1082,144,90,10,1,C
215G,215G,2,1090,1129,39,90,10,1,C
215G,215G,2,1145,1364,219,90,10,1,C
215G,215G,2,1459,1476,17,90,10,1,C
215G,215G,2,1485,1598,113,90,10,1,C
215G,215G,2,1615,1666,51,90,10,1,C
215G,215G,2,1675,1706,31,90,10,1,C
215G,215G,2,1713,1757,44,90,10,1,C
215G,215G,2,1762,1797,35,90,10,1,C
215G,215G,2,1815,1838,23,90,10,1,C
215G,215G,2,1843,2028,185,90,10,1,C
215G,215G,2,2063,2120,57,90,10,1,C
215G,215G,2,2129,2225,96,90,10,1,C
215G,215G,2,2258,2312,54,90,10,1,C
215G,215G,2,2322,2361,39,90,10,1,C
215G,215G,2,2372,2386,14,90,10,1,C
215G,215G,2,2403,2425,22,90,10,1,C
215G,215G,2,2441,2546,105,90,10,1,C
215G,215G,2,2571,2600,29,90,10,1,C
215G,215G,2,2648,2658,10,90,10,1,C
215G,215G,2,2668,2688,20,90,10,1,C
215G,215G,2,2697,2728,31,90,10,1,C
215G,215G,2,2740,2796,56,90,10,1,C
215G,215G,2,2940,3000,60,90,10,1,C
215G,215G,15,25,122,97,90,10,1,C
215G,215G,15,131,181,50,90,10,1,C
215G,215G,15,215,235,20,90,10,1,C
215G,215G,15,245,266,21,90,10,1,C
215G,215G,15,271,451,180,90,10,1,C
215G,215G,15,472,556,84,90,10,1,C
215G,215G,15,561,653,92,90,10,1,C
215G,215G,15,658,890,232,90,10,1,C
215G,215G,15,896,1054,158,90,10,1,C
215G,215G,15,1074,1256,182,90,10,1,C
215G,215G,15,1261,1337,76,90,10,1,C
215G,215G,15,1374,1622,248,90,10,1,C
215G,215G,15,1630,1899,269,90,10,1,C
215G,215G,15,1916,1930,14,90,10,1,C
215G,215G,15,1937,2061,124,90,10,1,C
215G,215G,15,2068,2120,52,90,10,1,C
215G,215G,15,2146,2339,193,90,10,1,C
215G,215G,15,2351,2520,169,90,10,1,C
215G,215G,15,2528,2579,51,90,10,1,C
215G,215G,15,2604,2764,160,90,10,1,C
215G,215G,15,2770,2858,88,90,10,1,C
215G,215G,15,2875,2948,73,90,10,1,C
215G,215G,15,2982,3000,18,90,10,1,C
215G,215G,28,5,20,15,90,10,1,C
215G,215G,28,40,125,85,90,10,1,C
215G,215G,28,133,159,26,90,10,1,C
215G,215G,28,165,176,11,90,10,1,C
215G,215G,28,182,206,24,90,10,1,C
215G,215G,28,225,298,73,90,10,1,C
215G,215G,28,360,380,20,90,10,1,C
215G,215G,28,467,541,74,90,10,1,C
215G,215G,28,569,626,57,90,10,1,C
215G,215G,28,644,669,25,90,10,1,C
215G,215G,28,680,720,40,90,10,1,C
215G,215G,28,735,754,19,90,10,1,C
215G,215G,28,869,885,16,90,10,1,C
215G,215G,28,976,1000,24,90,10,1,C
215G,215G,28,1029,1081,52,90,10,1,C
215G,215G,28,1095,1105,10,90,10,1,C
215G,215G,28,1110,1145,35,90,10,1,C
215G,215G,28,1243,1279,36,90,10,1,C
215G,215G,28,1411,1433,22,90,10,1,C
215G,215G,28,1439,1452,13,90,10,1,C
215G,215G,28,1483,1727,244,90,10,1,C
215G,215G,28,1736,1775,39,90,10,1,C
215G,215G,28,1796,1844,48,90,10,1,C
215G,215G,28,1851,2019,168,90,10,1,C
215G,215G,28,2029,2040,11,90,10,1,C
215G,215G,28,2045,2148,103,90,10,1,C
215G,215G,28,2158,2344,186,90,10,1,C
215G,215G,28,2354,2490,136,90,10,1,C
215G,215G,28,2495,2630,135,90,10,1,C
215G,215G,28,2642,2914,272,90,10,1,C
215G,215G,28,2919,3000,81,90,10,1,C
216A,216A,2,0,27,27,90,10,1,C
216A,216A,2,52,62,10,90,10,1,C
216A,216A,2,80,120,40,90,10,1,C
216A,216A,2,209,219,10,90,10,1,C
216A,216A,2,489,501,12,90,10,1,C
216A,216A,2,625,647,22,90,10,1,C
216A,216A,2,655,702,47,90,10,1,C
216A,216A,2,722,733,11,90,10,1,C
216A,216A,2,738,760,22,90,10,1,C
216A,216A,2,770,782,12,90,10,1,C
216A,216A,2,864,891,27,90,10,1,C
216A,216A,2,966,985,19,90,10,1,C
216A,216A,2,1020,1049,29,90,10,1,C
216A,216A,2,1094,1117,23,90,10,1,C
216A,216A,2,1371,1405,34,90,10,1,C
216A,216A,2,1583,1620,37,90,10,1,C
216A,216A,2,1976,1994,18,90,10,1,C
216A,216A,2,2034,2047,13,90,10,1,C
216A,216A,2,2238,2258,20,90,10,1,C
216A,216A,2,2263,2298,35,90,10,1,C
216A,216A,2,2320,2365,45,90,10,1,C
216A,216A,2,2377,2407,30,90,10,1,C
216A,216A,2,2478,2517,39,90,10,1,C
216A,216A,2,2544,2618,74,90,10,1,C
216A,216A,2,2729,2778,49,90,10,1,C
216A,216A,2,2844,2885,41,90,10,1,C
216A,216A,2,2965,3000,35,90,10,1,C
216A,216A,15,20,60,40,90,10,1,C
216A,216A,15,94,109,15,90,10,1,C
216A,216A,15,118,137,19,90,10,1,C
216A,216A,15,158,181,23,90,10,1,C
216A,216A,15,193,255,62,90,10,1,C
216A,216A,15,263,275,12,90,10,1,C
216A,216A,15,323,342,19,90,10,1,C
216A,216A,15,425,447,22,90,10,1,C
216A,216A,15,468,494,26,90,10,1,C
216A,216A,15,503,520,17,90,10,1,C
216A,216A,15,533,589,56,90,10,1,C
216A,216A,15,594,668,74,90,10,1,C
216A,216A,15,685,711,26,90,10,1,C
216A,216A,15,762,790,28,90,10,1,C
216A,216A,15,815,866,51,90,10,1,C
216A,216A,15,872,882,10,90,10,1,C
216A,216A,15,899,918,19,90,10,1,C
216A,216A,15,935,971,36,90,10,1,C
216A,216A,15,981,1016,35,90,10,1,C
216A,216A,15,1175,1192,17,90,10,1,C
216A,216A,15,1690,1718,28,90,10,1,C
216A,216A,15,1725,1748,23,90,10,1,C
216A,216A,15,1768,1805,37,90,10,1,C
216A,216A,15,1833,1874,41,90,10,1,C
216A,216A,15,1910,1995,85,90,10,1,C
216A,216A,15,2126,2144,18,90,10,1,C
216A,216A,15,2171,2181,10,90,10,1,C
216A,216A,15,2199,2225,26,90,10,1,C
216A,216A,15,2691,2717,26,90,10,1,C
216A,216A,15,2726,2742,16,90,10,1,C
216A,216A,15,2759,2776,17,90,10,1,C
216A,216A,15,2790,2809,19,90,10,1,C
216A,216A,15,2828,2860,32,90,10,1,C
216A,216A,28,2,16,14,90,10,1,C
216A,216A,28,57,80,23,90,10,1,C
216A,216A,28,107,154,47,90,10,1,C
216A,216A,28,291,313,22,90,10,1,C
216A,216A,28,356,371,15,90,10,1,C
216A,216A,28,427,451,24,90,10,1,C
216A,216A,28,488,498,10,90,10,1,C
216A,216A,28,503,524,21,90,10,1,C
216A,216A,28,855,873,18,90,10,1,C
216A,216A,28,1490,1540,50,90,10,1,C
216A,216A,28,1615,1646,31,90,10,1,C
216A,216A,28,1707,1741,34,90,10,1,C
216A,216A,28,2133,2151,18,90,10,1,C
216A,216A,28,2171,2191,20,90,10,1,C
216A,216A,28,2197,2233,36,90,10,1,C
216A,216A,28,2303,2326,23,90,10,1,C
216A,216A,28,2337,2394,57,90,10,1,C
216A,216A,28,2415,2446,31,90,10,1,C
216A,216A,28,2458,2481,23,90,10,1,C
216A,216A,28,2521,2582,61,90,10,1,C
216A,216A,28,2730,2756,26,90,10,1,C
216A,216A,28,2761,2778,17,90,10,1,C
216A,216A,28,2783,2795,12,90,10,1,C
216A,216A,28,2898,2921,23,90,10,1,C
216A,216A,28,2926,2944,18,90,10,1,C
216G,216G,2,72,213,141,90,10,1,C
216G,216G,2,234,267,33,90,10,1,C
216G,216G,2,328,350,22,90,10,1,C
216G,216G,2,388,434,46,90,10,1,C
216G,216G,2,452,529,77,90,10,1,C
216G,216G,2,569,688,119,90,10,1,C
216G,216G,2,707,924,217,90,10,1,C
216G,216G,2,933,1140,207,90,10,1,C
216G,216G,2,1145,1160,15,90,10,1,C
216G,216G,2,1177,1247,70,90,10,1,C
216G,216G,2,1255,1285,30,90,10,1,C
216G,216G,2,1300,1328,28,90,10,1,C
216G,216G,2,1336,1425,89,90,10,1,C
216G,216G,2,1432,1450,18,90,10,1,C
216G,216G,2,1456,1481,25,90,10,1,C
216G,216G,2,1498,1530,32,90,10,1,C
216G,216G,2,1550,1585,35,90,10,1,C
216G,216G,2,1592,2081,489,90,10,1,C
216G,216G,2,2094,2198,104,90,10,1,C
216G,216G,2,2218,2269,51,90,10,1,C
216G,216G,2,2305,2355,50,90,10,1,C
216G,216G,2,2367,2407,40,90,10,1,C
216G,216G,2,2442,2527,85,90,10,1,C
216G,216G,2,2569,2581,12,90,10,1,C
216G,216G,2,2612,2713,101,90,10,1,C
216G,216G,2,2725,2797,72,90,10,1,C
216G,216G,2,2805,2913,108,90,10,1,C
216G,216G,2,2934,3000,66,90,10,1,C
216G,216G,15,30,44,14,90,10,1,C
216G,216G,15,55,85,30,90,10,1,C
216G,216G,15,99,119,20,90,10,1,C
216G,216G,15,127,193,66,90,10,1,C
216G,216G,15,244,264,20,90,10,1,C
216G,216G,15,275,324,49,90,10,1,C
216G,216G,15,360,423,63,90,10,1,C
216G,216G,15,435,465,30,90,10,1,C
216G,216G,15,470,624,154,90,10,1,C
216G,216G,15,685,714,29,90,10,1,C
216G,216G,15,749,772,23,90,10,1,C
216G,216G,15,777,948,171,90,10,1,C
216G,216G,15,956,970,14,90,10,1,C
216G,216G,15,1005,1018,13,90,10,1,C
216G,216G,15,1039,1080,41,90,10,1,C
216G,216G,15,1086,1323,237,90,10,1,C
216G,216G,15,1379,1397,18,90,10,1,C
216G,216G,15,1422,1440,18,90,10,1,C
216G,216G,15,1464,1492,28,90,10,1,C
216G,216G,15,1552,1697,145,90,10,1,C
216G,216G,15,1723,2139,416,90,10,1,C
216G,216G,15,2162,2221,59,90,10,1,C
216G,216G,15,2236,2287,51,90,10,1,C
216G,216G,15,2312,2470,158,90,10,1,C
216G,216G,15,2492,2608,116,90,10,1,C
216G,216G,15,2644,2677,33,90,10,1,C
216G,216G,15,2856,2877,21,90,10,1,C
216G,216G,15,2882,2895,13,90,10,1,C
216G,216G,15,2927,2963,36,90,10,1,C
216G,216G,15,2968,2990,22,90,10,1,C
216G,216G,28,22,82,60,90,10,1,C
216G,216G,28,111,222,111,90,10,1,C
216G,216G,28,230,267,37,90,10,1,C
216G,216G,28,288,556,268,90,10,1,C
216G,216G,28,570,615,45,90,10,1,C
216G,216G,28,630,669,39,90,10,1,C
216G,216G,28,681,706,25,90,10,1,C
216G,216G,28,717,742,25,90,10,1,C
216G,216G,28,771,835,64,90,10,1,C
216G,216G,28,888,1001,113,90,10,1,C
216G,216G,28,1016,1060,44,90,10,1,C
216G,216G,28,1075,1225,150,90,10,1,C
216G,216G,28,1270,1709,439,90,10,1,C
216G,216G,28,1717,1998,281,90,10,1,C
216G,216G,28,2014,2054,40,90,10,1,C
216G,216G,28,2081,2177,96,90,10,1,C
216G,216G,28,2192,2287,95,90,10,1,C
216G,216G,28,2293,2452,159,90,10,1,C
216G,216G,28,2510,2541,31,90,10,1,C
216G,216G,28,2560,2595,35,90,10,1,C
216G,216G,28,2624,2656,32,90,10,1,C
216G,216G,28,2688,2773,85,90,10,1,C
216G,216G,28,2784,2877,93,90,10,1,C
216G,216G,28,2919,2965,46,90,10,1,C
216G,216G,28,2975,3000,25,90,10,1,C
217A,217A,2,0,28,28,90,10,1,C
217A,217A,2,42,75,33,90,10,1,C
217A,217A,2,87,158,71,90,10,1,C
217A,217A,2,170,181,11,90,10,1,C
217A,217A,2,212,380,168,90,10,1,C
217A,217A,2,387,470,83,90,10,1,C
217A,217A,2,500,658,158,90,10,1,C
217A,217A,2,670,711,41,90,10,1,C
217A,217A,2,775,875,100,90,10,1,C
217A,217A,2,901,919,18,90,10,1,C
217A,217A,2,933,974,41,90,10,1,C
217A,217A,2,982,1006,24,90,10,1,C
217A,217A,2,1064,1100,36,90,10,1,C
217A,217A,2,1126,1146,20,90,10,1,C
217A,217A,2,1157,1196,39,90,10,1,C
217A,217A,2,1209,1263,54,90,10,1,C
217A,217A,2,1299,1392,93,90,10,1,C
217A,217A,2,1409,1486,77,90,10,1,C
217A,217A,2,1492,1515,23,90,10,1,C
217A,217A,2,1533,1566,33,90,10,1,C
217A,217A,2,1583,1621,38,90,10,1,C
217A,217A,2,1694,1786,92,90,10,1,C
217A,217A,2,1812,1916,104,90,10,1,C
217A,217A,2,1941,1983,42,90,10,1,C
217A,217A,2,2024,2074,50,90,10,1,C
217A,217A,2,2130,2247,117,90,10,1,C
217A,217A,2,2285,2312,27,90,10,1,C
217A,217A,2,2346,2391,45,90,10,1,C
217A,217A,2,2400,2433,33,90,10,1,C
217A,217A,2,2467,2478,11,90,10,1,C
217A,217A,2,2538,2552,14,90,10,1,C
217A,217A,2,2564,2646,82,90,10,1,C
217A,217A,2,2653,2740,87,90,10,1,C
217A,217A,2,2752,2776,24,90,10,1,C
217A,217A,2,2790,2803,13,90,10,1,C
217A,217A,2,2843,2859,16,90,10,1,C
217A,217A,2,2895,2954,59,90,10,1,C
217A,217A,2,2976,3000,24,90,10,1,C
217A,217A,15,3,21,18,90,10,1,C
217A,217A,15,40,153,113,90,10,1,C
217A,217A,15,171,220,49,90,10,1,C
217A,217A,15,234,324,90,90,10,1,C
217A,217A,15,361,393,32,90,10,1,C
217A,217A,15,402,548,146,90,10,1,C
217A,217A,15,563,586,23,90,10,1,C
217A,217A,15,591,614,23,90,10,1,C
217A,217A,15,651,718,67,90,10,1,C
217A,217A,15,738,778,40,90,10,1,C
217A,217A,15,793,876,83,90,10,1,C
217A,217A,15,909,932,23,90,10,1,C
217A,217A,15,963,1024,61,90,10,1,C
217A,217A,15,1050,1235,185,90,10,1,C
217A,217A,15,1289,1372,83,90,10,1,C
217A,217A,15,1477,1521,44,90,10,1,C
217A,217A,15,1581,1621,40,90,10,1,C
217A,217A,15,1642,1655,13,90,10,1,C
217A,217A,15,1683,1858,175,90,10,1,C
217A,217A,15,2441,2636,195,90,10,1,C
217A,217A,15,2645,2773,128,90,10,1,C
217A,217A,15,2791,2847,56,90,10,1,C
217A,217A,15,2859,2945,86,90,10,1,C
217A,217A,15,2977,3000,23,90,10,1,C
217A,217A,28,0,15,15,90,10,1,C
217A,217A,28,24,40,16,90,10,1,C
217A,217A,28,55,125,70,90,10,1,C
217A,217A,28,140,245,105,90,10,1,C
217A,217A,28,309,429,120,90,10,1,C
217A,217A,28,444,494,50,90,10,1,C
217A,217A,28,518,566,48,90,10,1,C
217A,217A,28,584,676,92,90,10,1,C
217A,217A,28,795,859,64,90,10,1,C
217A,217A,28,871,929,58,90,10,1,C
217A,217A,28,941,1048,107,90,10,1,C
217A,217A,28,1194,1207,13,90,10,1,C
217A,217A,28,1267,1295,28,90,10,1,C
217A,217A,28,1314,1346,32,90,10,1,C
217A,217A,28,1368,1394,26,90,10,1,C
217A,217A,28,1429,1475,46,90,10,1,C
217A,217A,28,1491,1527,36,90,10,1,C
217A,217A,28,1562,1584,22,90,10,1,C
217A,217A,28,1597,1628,31,90,10,1,C
217A,217A,28,1684,1744,60,90,10,1,C
217A,217A,28,1915,1952,37,90,10,1,C
217A,217A,28,2009,2028,19,90,10,1,C
217A,217A,28,2035,2059,24,90,10,1,C
217A,217A,28,2111,2180,69,90,10,1,C
217A,217A,28,2208,2222,14,90,10,1,C
217A,217A,28,2297,2334,37,90,10,1,C
217A,217A,28,2357,2367,10,90,10,1,C
217A,217A,28,2391,2410,19,90,10,1,C
217A,217A,28,2421,2475,54,90,10,1,C
217A,217A,28,2486,2532,46,90,10,1,C
217A,217A,28,2564,2622,58,90,10,1,C
217A,217A,28,2676,2792,116,90,10,1,C
217A,217A,28,2816,2830,14,90,10,1,C
217A,217A,28,2836,2922,86,90,10,1,C
217A,217A,28,2933,2971,38,90,10,1,C
217A,217A,28,2980,2991,11,90,10,1,C
217G,217G,2,0,63,63,90,10,1,C
217G,217G,2,103,144,41,90,10,1,C
217G,217G,2,192,209,17,90,10,1,C
217G,217G,2,214,261,47,90,10,1,C
217G,217G,2,281,354,73,90,10,1,C
217G,217G,2,376,413,37,90,10,1,C
217G,217G,2,495,537,42,90,10,1,C
217G,217G,2,600,628,28,90,10,1,C
217G,217G,2,656,674,18,90,10,1,C
217G,217G,2,692,751,59,90,10,1,C
217G,217G,2,772,818,46,90,10,1,C
217G,217G,2,855,866,11,90,10,1,C
217G,217G,2,872,899,27,90,10,1,C
217G,217G,2,937,1028,91,90,10,1,C
217G,217G,2,1051,1083,32,90,10,1,C
217G,217G,2,1088,1126,38,90,10,1,C
217G,217G,2,1177,1198,21,90,10,1,C
217G,217G,2,1211,1245,34,90,10,1,C
217G,217G,2,1267,1438,171,90,10,1,C
217G,217G,2,1446,1481,35,90,10,1,C
217G,217G,2,1521,1560,39,90,10,1,C
217G,217G,2,1644,1711,67,90,10,1,C
217G,217G,2,1730,1765,35,90,10,1,C
217G,217G,2,1789,1802,13,90,10,1,C
217G,217G,2,1883,1904,21,90,10,1,C
217G,217G,2,1995,2020,25,90,10,1,C
217G,217G,2,2057,2108,51,90,10,1,C
217G,217G,2,2139,2294,155,90,10,1,C
217G,217G,2,2334,2498,164,90,10,1,C
217G,217G,2,2546,2605,59,90,10,1,C
217G,217G,2,2677,2751,74,90,10,1,C
217G,217G,2,2810,2948,138,90,10,1,C
217G,217G,2,2975,3000,25,90,10,1,C
217G,217G,15,11,47,36,90,10,1,C
217G,217G,15,80,97,17,90,10,1,C
217G,217G,15,134,155,21,90,10,1,C
217G,217G,15,202,252,50,90,10,1,C
217G,217G,15,317,356,39,90,10,1,C
217G,217G,15,391,492,101,90,10,1,C
217G,217G,15,529,548,19,90,10,1,C
217G,217G,15,592,641,49,90,10,1,C
217G,217G,15,662,770,108,90,10,1,C
217G,217G,15,809,824,15,90,10,1,C
217G,217G,15,959,983,24,90,10,1,C
217G,217G,15,989,1034,45,90,10,1,C
217G,217G,15,1057,1068,11,90,10,1,C
217G,217G,15,1148,1176,28,90,10,1,C
217G,217G,15,1237,1315,78,90,10,1,C
217G,217G,15,1329,1425,96,90,10,1,C
217G,217G,15,1432,1502,70,90,10,1,C
217G,217G,15,1510,1653,143,90,10,1,C
217G,217G,15,1671,1729,58,90,10,1,C
217G,217G,15,1780,1890,110,90,10,1,C
217G,217G,15,1910,1947,37,90,10,1,C
217G,217G,15,1995,2049,54,90,10,1,C
217G,217G,15,2064,2087,23,90,10,1,C
217G,217G,15,2124,2255,131,90,10,1,C
217G,217G,15,2275,2345,70,90,10,1,C
217G,217G,15,2357,2386,29,90,10,1,C
217G,217G,15,2408,2466,58,90,10,1,C
217G,217G,15,2510,2523,13,90,10,1,C
217G,217G,15,2530,2540,10,90,10,1,C
217G,217G,15,2615,2638,23,90,10,1,C
217G,217G,15,2824,2856,32,90,10,1,C
217G,217G,15,2887,2911,24,90,10,1,C
217G,217G,28,43,80,37,90,10,1,C
217G,217G,28,106,122,16,90,10,1,C
217G,217G,28,165,209,44,90,10,1,C
217G,217G,28,218,266,48,90,10,1,C
217G,217G,28,297,345,48,90,10,1,C
217G,217G,28,382,433,51,90,10,1,C
217G,217G,28,481,533,52,90,10,1,C
217G,217G,28,610,626,16,90,10,1,C
217G,217G,28,685,728,43,90,10,1,C
217G,217G,28,735,760,25,90,10,1,C
217G,217G,28,781,885,104,90,10,1,C
217G,217G,28,907,1101,194,90,10,1,C
217G,217G,28,1113,1134,21,90,10,1,C
217G,217G,28,1164,1199,35,90,10,1,C
217G,217G,28,1210,1241,31,90,10,1,C
217G,217G,28,1260,1300,40,90,10,1,C
217G,217G,28,1332,1350,18,90,10,1,C
217G,217G,28,1335,1400,65,90,10,1,C
217G,217G,28,1420,1444,24,90,10,1,C
217G,217G,28,1494,1523,29,90,10,1,C
217G,217G,28,1528,1587,59,90,10,1,C
217G,217G,28,1605,1693,88,90,10,1,C
217G,217G,28,1702,1774,72,90,10,1,C
217G,217G,28,1788,1805,17,90,10,1,C
217G,217G,28,1824,1960,136,90,10,1,C
217G,217G,28,1967,2001,34,90,10,1,C
217G,217G,28,2007,2070,63,90,10,1,C
217G,217G,28,2180,2196,16,90,10,1,C
217G,217G,28,2221,2281,60,90,10,1,C
217G,217G,28,2298,2385,87,90,10,1,C
217G,217G,28,2405,2498,93,90,10,1,C
217G,217G,28,2520,2545,25,90,10,1,C
217G,217G,28,2585,2669,84,90,10,1,C
217G,217G,28,2725,2801,76,90,10,1,C
217G,217G,28,2836,2893,57,90,10,1,C
217G,217G,28,2901,3000,99,90,10,1,C
218A,218A,2,28,42,14,90,10,1,C
218A,218A,2,65,100,35,90,10,1,C
218A,218A,2,105,171,66,90,10,1,C
218A,218A,2,193,303,110,90,10,1,C
218A,218A,2,321,345,24,90,10,1,C
218A,218A,2,352,381,29,90,10,1,C
218A,218A,2,480,500,20,90,10,1,C
218A,218A,2,509,553,44,90,10,1,C
218A,218A,2,571,618,47,90,10,1,C
218A,218A,2,637,659,22,90,10,1,C
218A,218A,2,749,779,30,90,10,1,C
218A,218A,2,785,795,10,90,10,1,C
218A,218A,2,860,877,17,90,10,1,C
218A,218A,2,895,920,25,90,10,1,C
218A,218A,2,930,986,56,90,10,1,C
218A,218A,2,1009,1019,10,90,10,1,C
218A,218A,2,1031,1110,79,90,10,1,C
218A,218A,2,1185,1221,36,90,10,1,C
218A,218A,2,1262,1278,16,90,10,1,C
218A,218A,2,1292,1338,46,90,10,1,C
218A,218A,2,1357,1415,58,90,10,1,C
218A,218A,2,1493,1568,75,90,10,1,C
218A,218A,2,1584,1606,22,90,10,1,C
218A,218A,2,1611,1679,68,90,10,1,C
218A,218A,2,1698,1745,47,90,10,1,C
218A,218A,2,1761,1807,46,90,10,1,C
218A,218A,2,1815,1843,28,90,10,1,C
218A,218A,2,1850,1899,49,90,10,1,C
218A,218A,2,1913,1923,10,90,10,1,C
218A,218A,2,1953,2048,95,90,10,1,C
218A,218A,2,2060,2127,67,90,10,1,C
218A,218A,2,2143,2245,102,90,10,1,C
218A,218A,2,2254,2374,120,90,10,1,C
218A,218A,2,2405,2429,24,90,10,1,C
218A,218A,2,2434,2460,26,90,10,1,C
218A,218A,2,2477,2505,28,90,10,1,C
218A,218A,2,2538,2562,24,90,10,1,C
218A,218A,2,2592,2612,20,90,10,1,C
218A,218A,2,2705,2733,28,90,10,1,C
218A,218A,2,2770,2780,10,90,10,1,C
218A,218A,15,65,77,12,90,10,1,C
218A,218A,15,174,195,21,90,10,1,C
218A,218A,15,238,256,18,90,10,1,C
218A,218A,15,347,405,58,90,10,1,C
218A,218A,15,424,449,25,90,10,1,C
218A,218A,15,545,567,22,90,10,1,C
218A,218A,15,743,760,17,90,10,1,C
218A,218A,15,797,812,15,90,10,1,C
218A,218A,15,866,897,31,90,10,1,C
218A,218A,15,939,950,11,90,10,1,C
218A,218A,15,991,1032,41,90,10,1,C
218A,218A,15,1058,1081,23,90,10,1,C
218A,218A,15,1101,1117,16,90,10,1,C
218A,218A,15,1155,1176,21,90,10,1,C
218A,218A,15,1201,1228,27,90,10,1,C
218A,218A,15,1375,1400,25,90,10,1,C
218A,218A,15,1450,1527,77,90,10,1,C
218A,218A,15,1554,1607,53,90,10,1,C
218A,218A,15,1652,1686,34,90,10,1,C
218A,218A,15,1717,1730,13,90,10,1,C
218A,218A,15,1795,1805,10,90,10,1,C
218A,218A,15,1831,1873,42,90,10,1,C
218A,218A,15,1900,1941,41,90,10,1,C
218A,218A,15,1946,1965,19,90,10,1,C
218A,218A,15,1985,2006,21,90,10,1,C
218A,218A,15,2011,2052,41,90,10,1,C
218A,218A,15,2064,2116,52,90,10,1,C
218A,218A,15,2145,2170,25,90,10,1,C
218A,218A,15,2200,2239,39,90,10,1,C
218A,218A,15,2244,2351,107,90,10,1,C
218A,218A,15,2372,2405,33,90,10,1,C
218A,218A,15,2437,2479,42,90,10,1,C
218A,218A,15,2512,2608,96,90,10,1,C
218A,218A,15,2619,2656,37,90,10,1,C
218A,218A,15,2662,2701,39,90,10,1,C
218A,218A,15,2711,2777,66,90,10,1,C
218A,218A,15,2800,2820,20,90,10,1,C
218A,218A,15,2835,2858,23,90,10,1,C
218A,218A,15,2863,2891,28,90,10,1,C
218A,218A,15,2915,3000,85,90,10,1,C
218A,218A,28,21,39,18,90,10,1,C
218A,218A,28,50,85,35,90,10,1,C
218A,218A,28,102,122,20,90,10,1,C
218A,218A,28,196,258,62,90,10,1,C
218A,218A,28,276,304,28,90,10,1,C
218A,218A,28,329,368,39,90,10,1,C
218A,218A,28,397,428,31,90,10,1,C
218A,218A,28,437,456,19,90,10,1,C
218A,218A,28,467,494,27,90,10,1,C
218A,218A,28,503,561,58,90,10,1,C
218A,218A,28,612,653,41,90,10,1,C
218A,218A,28,666,678,12,90,10,1,C
218A,218A,28,693,719,26,90,10,1,C
218A,218A,28,724,757,33,90,10,1,C
218A,218A,28,773,795,22,90,10,1,C
218A,218A,28,808,914,106,90,10,1,C
218A,218A,28,989,1033,44,90,10,1,C
218A,218A,28,1055,1119,64,90,10,1,C
218A,218A,28,1155,1235,80,90,10,1,C
218A,218A,28,1246,1276,30,90,10,1,C
218A,218A,28,1306,1316,10,90,10,1,C
218A,218A,28,1351,1363,12,90,10,1,C
218A,218A,28,1415,1430,15,90,10,1,C
218A,218A,28,1541,1555,14,90,10,1,C
218A,218A,28,1565,1578,13,90,10,1,C
218A,218A,28,1618,1637,19,90,10,1,C
218A,218A,28,1676,1712,36,90,10,1,C
218A,218A,28,1730,1742,12,90,10,1,C
218A,218A,28,1762,1788,26,90,10,1,C
218A,218A,28,1802,1878,76,90,10,1,C
218A,218A,28,1900,1961,61,90,10,1,C
218A,218A,28,1970,1988,18,90,10,1,C
218A,218A,28,2025,2149,124,90,10,1,C
218A,218A,28,2154,2215,61,90,10,1,C
218A,218A,28,2255,2286,31,90,10,1,C
218A,218A,28,2296,2314,18,90,10,1,C
218A,218A,28,2340,2424,84,90,10,1,C
218A,218A,28,2456,2505,49,90,10,1,C
218A,218A,28,2532,2556,24,90,10,1,C
218A,218A,28,2576,2624,48,90,10,1,C
218A,218A,28,2638,2659,21,90,10,1,C
218A,218A,28,2676,2703,27,90,10,1,C
218A,218A,28,2710,2721,11,90,10,1,C
218A,218A,28,2732,2747,15,90,10,1,C
218A,218A,28,2820,2847,27,90,10,1,C
218A,218A,28,2853,2900,47,90,10,1,C
218A,218A,28,2925,2940,15,90,10,1,C
218G,218G,2,0,76,76,90,10,1,C
218G,218G,2,92,105,13,90,10,1,C
218G,218G,2,125,183,58,90,10,1,C
218G,218G,2,326,337,11,90,10,1,C
218G,218G,2,365,389,24,90,10,1,C
218G,218G,2,463,571,108,90,10,1,C
218G,218G,2,595,966,371,90,10,1,C
218G,218G,2,982,1002,20,90,10,1,C
218G,218G,2,1017,1122,105,90,10,1,C
218G,218G,2,1158,1229,71,90,10,1,C
218G,218G,2,1321,1331,10,90,10,1,C
218G,218G,2,1375,1400,25,90,10,1,C
218G,218G,2,1490,1591,101,90,10,1,C
218G,218G,2,1613,1659,46,90,10,1,C
218G,218G,2,1694,1778,84,90,10,1,C
218G,218G,2,1810,1893,83,90,10,1,C
218G,218G,2,1924,1973,49,90,10,1,C
218G,218G,2,1989,2162,173,90,10,1,C
218G,218G,2,2183,2202,19,90,10,1,C
218G,218G,2,2209,2220,11,90,10,1,C
218G,218G,2,2240,2267,27,90,10,1,C
218G,218G,2,2324,2342,18,90,10,1,C
218G,218G,2,2378,2463,85,90,10,1,C
218G,218G,2,2472,2503,31,90,10,1,C
218G,218G,2,2520,2535,15,90,10,1,C
218G,218G,2,2550,2565,15,90,10,1,C
218G,218G,2,2581,2612,31,90,10,1,C
218G,218G,2,2652,2712,60,90,10,1,C
218G,218G,2,2883,2924,41,90,10,1,C
218G,218G,2,2963,3000,37,90,10,1,C
218G,218G,15,42,70,28,90,10,1,C
218G,218G,15,538,572,34,90,10,1,C
218G,218G,15,667,941,274,90,10,1,C
218G,218G,15,964,994,30,90,10,1,C
218G,218G,15,1007,1019,12,90,10,1,C
218G,218G,15,1036,1047,11,90,10,1,C
218G,218G,15,1214,1280,66,90,10,1,C
218G,218G,15,1311,1481,170,90,10,1,C
218G,218G,15,1548,1566,18,90,10,1,C
218G,218G,15,1688,1732,44,90,10,1,C
218G,218G,15,1889,1900,11,90,10,1,C
218G,218G,15,2020,2051,31,90,10,1,C
218G,218G,15,2300,2376,76,90,10,1,C
218G,218G,15,2483,2530,47,90,10,1,C
218G,218G,15,2584,2637,53,90,10,1,C
218G,218G,15,2658,2715,57,90,10,1,C
218G,218G,15,2754,2804,50,90,10,1,C
218G,218G,15,2847,2891,44,90,10,1,C
218G,218G,15,2900,2960,60,90,10,1,C
218G,218G,15,2983,3000,17,90,10,1,C
218G,218G,28,73,97,24,90,10,1,C
218G,218G,28,254,278,24,90,10,1,C
218G,218G,28,312,332,20,90,10,1,C
218G,218G,28,359,373,14,90,10,1,C
218G,218G,28,396,429,33,90,10,1,C
218G,218G,28,491,515,24,90,10,1,C
218G,218G,28,530,562,32,90,10,1,C
218G,218G,28,621,662,41,90,10,1,C
218G,218G,28,690,810,120,90,10,1,C
218G,218G,28,891,919,28,90,10,1,C
218G,218G,28,931,978,47,90,10,1,C
218G,218G,28,998,1020,22,90,10,1,C
218G,218G,28,1112,1129,17,90,10,1,C
218G,218G,28,1136,1153,17,90,10,1,C
218G,218G,28,1390,1421,31,90,10,1,C
218G,218G,28,1480,1528,48,90,10,1,C
218G,218G,28,1553,1582,29,90,10,1,C
218G,218G,28,1597,1626,29,90,10,1,C
218G,218G,28,1634,1663,29,90,10,1,C
218G,218G,28,1834,1890,56,90,10,1,C
218G,218G,28,1995,2027,32,90,10,1,C
218G,218G,28,2332,2353,21,90,10,1,C
218G,218G,28,2405,2476,71,90,10,1,C
218G,218G,28,2497,2522,25,90,10,1,C
218G,218G,28,2527,2540,13,90,10,1,C
218G,218G,28,2625,2638,13,90,10,1,C
218G,218G,28,2646,2725,79,90,10,1,C
218G,218G,28,2743,2775,32,90,10,1,C
218G,218G,28,2788,2849,61,90,10,1,C
218G,218G,28,2871,2942,71,90,10,1,C
218G,218G,28,2980,3000,20,90,10,1,C
219A,219A,2,58,113,55,90,10,1,C
219A,219A,2,145,152,7,90,10,1,C
219A,219A,2,180,200,20,90,10,1,C
219A,219A,2,217,235,18,90,10,1,C
219A,219A,2,243,270,27,90,10,1,C
219A,219A,2,291,343,52,90,10,1,C
219A,219A,2,351,390,39,90,10,1,C
219A,219A,2,407,522,115,90,10,1,C
219A,219A,2,527,562,35,90,10,1,C
219A,219A,2,651,670,19,90,10,1,C
219A,219A,2,693,845,152,90,10,1,C
219A,219A,2,850,891,41,90,10,1,C
219A,219A,2,1015,1026,11,90,10,1,C
219A,219A,2,1031,1045,14,90,10,1,C
219A,219A,2,1073,1130,57,90,10,1,C
219A,219A,2,1155,1185,30,90,10,1,C
219A,219A,2,1194,1210,16,90,10,1,C
219A,219A,2,1218,1281,63,90,10,1,C
219A,219A,2,1298,1410,112,90,10,1,C
219A,219A,2,1419,1441,22,90,10,1,C
219A,219A,2,1462,1478,16,90,10,1,C
219A,219A,2,1487,1529,42,90,10,1,C
219A,219A,2,1540,1577,37,90,10,1,C
219A,219A,2,1586,1612,26,90,10,1,C
219A,219A,2,1620,1636,16,90,10,1,C
219A,219A,2,1692,1778,86,90,10,1,C
219A,219A,2,1996,2015,19,90,10,1,C
219A,219A,2,2058,2075,17,90,10,1,C
219A,219A,2,2109,2171,62,90,10,1,C
219A,219A,2,2180,2202,22,90,10,1,C
219A,219A,2,2252,2271,19,90,10,1,C
219A,219A,2,2285,2295,10,90,10,1,C
219A,219A,2,2331,2359,28,90,10,1,C
219A,219A,2,2388,2408,20,90,10,1,C
219A,219A,2,2548,2591,43,90,10,1,C
219A,219A,2,2723,2748,25,90,10,1,C
219A,219A,2,2825,2847,22,90,10,1,C
219A,219A,2,2886,2906,20,90,10,1,C
219A,219A,2,2937,2958,21,90,10,1,C
219A,219A,15,0,67,67,90,10,1,C
219A,219A,15,462,501,39,90,10,1,C
219A,219A,15,520,626,106,90,10,1,C
219A,219A,15,650,707,57,90,10,1,C
219A,219A,15,727,750,23,90,10,1,C
219A,219A,15,769,801,32,90,10,1,C
219A,219A,15,808,857,49,90,10,1,C
219A,219A,15,876,928,52,90,10,1,C
219A,219A,15,1140,1156,16,90,10,1,C
219A,219A,15,1392,1414,22,90,10,1,C
219A,219A,15,1440,1466,26,90,10,1,C
219A,219A,15,1506,1519,13,90,10,1,C
219A,219A,15,1540,1554,14,90,10,1,C
219A,219A,15,1583,1606,23,90,10,1,C
219A,219A,15,1610,1627,17,90,10,1,C
219A,219A,15,1647,1660,13,90,10,1,C
219A,219A,15,1685,1708,23,90,10,1,C
219A,219A,15,1851,1880,29,90,10,1,C
219A,219A,15,1900,1996,96,90,10,1,C
219A,219A,15,2055,2080,25,90,10,1,C
219A,219A,15,2116,2136,20,90,10,1,C
219A,219A,15,2174,2196,22,90,10,1,C
219A,219A,15,2785,2802,17,90,10,1,C
219A,219A,15,2885,2911,26,90,10,1,C
219A,219A,15,2925,2981,56,90,10,1,C
219A,219A,28,10,22,12,90,10,1,C
219A,219A,28,56,87,31,90,10,1,C
219A,219A,28,93,161,68,90,10,1,C
219A,219A,28,169,192,23,90,10,1,C
219A,219A,28,208,220,12,90,10,1,C
219A,219A,28,284,326,42,90,10,1,C
219A,219A,28,443,457,14,90,10,1,C
219A,219A,28,505,525,20,90,10,1,C
219A,219A,28,976,1001,25,90,10,1,C
219A,219A,28,1023,1045,22,90,10,1,C
219A,219A,28,1110,1133,23,90,10,1,C
219A,219A,28,1161,1222,61,90,10,1,C
219A,219A,28,1264,1390,126,90,10,1,C
219A,219A,28,1753,1785,32,90,10,1,C
219A,219A,28,1798,1825,27,90,10,1,C
219A,219A,28,1984,2000,16,90,10,1,C
219A,219A,28,2015,2031,16,90,10,1,C
219A,219A,28,2275,2296,21,90,10,1,C
219A,219A,28,2372,2391,19,90,10,1,C
219A,219A,28,2397,2431,34,90,10,1,C
219A,219A,28,2450,2517,67,90,10,1,C
219A,219A,28,2549,2574,25,90,10,1,C
219A,219A,28,2596,2623,27,90,10,1,C
219A,219A,28,2655,2678,23,90,10,1,C
219A,219A,28,2720,2783,63,90,10,1,C
219A,219A,28,2788,2820,32,90,10,1,C
219A,219A,28,2844,2861,17,90,10,1,C
219A,219A,28,2950,2968,18,90,10,1,C
219G,219G,2,224,263,39,90,10,1,C
219G,219G,2,275,321,46,90,10,1,C
219G,219G,2,349,417,68,90,10,1,C
219G,219G,2,493,523,30,90,10,1,C
219G,219G,2,538,566,28,90,10,1,C
219G,219G,2,640,687,47,90,10,1,C
219G,219G,2,705,827,122,90,10,1,C
219G,219G,2,883,957,74,90,10,1,C
219G,219G,2,973,987,14,90,10,1,C
219G,219G,2,1091,1160,69,90,10,1,C
219G,219G,2,1189,1207,18,90,10,1,C
219G,219G,2,1215,1266,51,90,10,1,C
219G,219G,2,1271,1315,44,90,10,1,C
219G,219G,2,1328,1351,23,90,10,1,C
219G,219G,2,1382,1404,22,90,10,1,C
219G,219G,2,1415,1428,13,90,10,1,C
219G,219G,2,1448,1515,67,90,10,1,C
219G,219G,2,1715,1752,37,90,10,1,C
219G,219G,2,1968,1994,26,90,10,1,C
219G,219G,2,2135,2161,26,90,10,1,C
219G,219G,2,2174,2192,18,90,10,1,C
219G,219G,2,2208,2253,45,90,10,1,C
219G,219G,2,2276,2315,39,90,10,1,C
219G,219G,2,2338,2353,15,90,10,1,C
219G,219G,2,2365,2384,19,90,10,1,C
219G,219G,2,2395,2420,25,90,10,1,C
219G,219G,2,2429,2446,17,90,10,1,C
219G,219G,2,2465,2496,31,90,10,1,C
219G,219G,2,2506,2541,35,90,10,1,C
219G,219G,2,2554,2595,41,90,10,1,C
219G,219G,2,2651,2662,11,90,10,1,C
219G,219G,2,2683,2712,29,90,10,1,C
219G,219G,2,2880,2893,13,90,10,1,C
219G,219G,2,2909,2929,20,90,10,1,C
219G,219G,2,2942,2990,48,90,10,1,C
219G,219G,15,41,83,42,90,10,1,C
219G,219G,15,89,123,34,90,10,1,C
219G,219G,15,182,246,64,90,10,1,C
219G,219G,15,349,378,29,90,10,1,C
219G,219G,15,388,478,90,90,10,1,C
219G,219G,15,483,497,14,90,10,1,C
219G,219G,15,513,539,26,90,10,1,C
219G,219G,15,601,682,81,90,10,1,C
219G,219G,15,782,839,57,90,10,1,C
219G,219G,15,860,924,64,90,10,1,C
219G,219G,15,1114,1168,54,90,10,1,C
219G,219G,15,1172,1183,11,90,10,1,C
219G,219G,15,1199,1240,41,90,10,1,C
219G,219G,15,1272,1295,23,90,10,1,C
219G,219G,15,1301,1379,78,90,10,1,C
219G,219G,15,1397,1457,60,90,10,1,C
219G,219G,15,1688,1713,25,90,10,1,C
219G,219G,15,1728,1770,42,90,10,1,C
219G,219G,15,1775,1806,31,90,10,1,C
219G,219G,15,1830,1842,12,90,10,1,C
219G,219G,15,1850,1894,44,90,10,1,C
219G,219G,15,1915,1997,82,90,10,1,C
219G,219G,15,2021,2086,65,90,10,1,C
219G,219G,15,2124,2198,74,90,10,1,C
219G,219G,15,2211,2360,149,90,10,1,C
219G,219G,15,2409,2427,18,90,10,1,C
219G,219G,15,2489,2540,51,90,10,1,C
219G,219G,15,2736,2761,25,90,10,1,C
219G,219G,15,2882,2973,91,90,10,1,C
219G,219G,15,2979,3000,21,90,10,1,C
219G,219G,28,0,52,52,90,10,1,C
219G,219G,28,87,102,15,90,10,1,C
219G,219G,28,110,122,12,90,10,1,C
219G,219G,28,173,195,22,90,10,1,C
219G,219G,28,251,334,83,90,10,1,C
219G,219G,28,365,470,105,90,10,1,C
219G,219G,28,496,520,24,90,10,1,C
219G,219G,28,552,595,43,90,10,1,C
219G,219G,28,609,631,22,90,10,1,C
219G,219G,28,648,669,21,90,10,1,C
219G,219G,28,691,745,54,90,10,1,C
219G,219G,28,751,852,101,90,10,1,C
219G,219G,28,965,1140,175,90,10,1,C
219G,219G,28,1170,1196,26,90,10,1,C
219G,219G,28,1220,1237,17,90,10,1,C
219G,219G,28,1295,1335,40,90,10,1,C
219G,219G,28,1344,1416,72,90,10,1,C
219G,219G,28,1426,1470,44,90,10,1,C
219G,219G,28,1476,1539,63,90,10,1,C
219G,219G,28,1595,1623,28,90,10,1,C
219G,219G,28,1638,1757,119,90,10,1,C
219G,219G,28,1767,1777,10,90,10,1,C
219G,219G,28,1811,1828,17,90,10,1,C
219G,219G,28,1833,1880,47,90,10,1,C
219G,219G,28,1923,2000,77,90,10,1,C
219G,219G,28,2024,2104,80,90,10,1,C
219G,219G,28,2121,2154,33,90,10,1,C
219G,219G,28,2285,2311,26,90,10,1,C
219G,219G,28,2317,2363,46,90,10,1,C
219G,219G,28,2394,2465,71,90,10,1,C
219G,219G,28,2488,2563,75,90,10,1,C
219G,219G,28,2581,2635,54,90,10,1,C
219G,219G,28,2705,2753,48,90,10,1,C
219G,219G,28,2758,2870,112,90,10,1,C
219G,219G,28,2935,3000,65,90,10,1,C
220A,220A,2,0,19,19,90,10,1,C
220A,220A,2,48,77,29,90,10,1,C
220A,220A,2,241,357,116,90,10,1,C
220A,220A,2,367,380,13,90,10,1,C
220A,220A,2,423,438,15,90,10,1,C
220A,220A,2,655,683,28,90,10,1,C
220A,220A,2,722,753,31,90,10,1,C
220A,220A,2,831,851,20,90,10,1,C
220A,220A,2,856,871,15,90,10,1,C
220A,220A,2,947,970,23,90,10,1,C
220A,220A,2,975,1024,49,90,10,1,C
220A,220A,2,1029,1040,11,90,10,1,C
220A,220A,2,1050,1062,12,90,10,1,C
220A,220A,2,1073,1090,17,90,10,1,C
220A,220A,2,1095,1117,22,90,10,1,C
220A,220A,2,1256,1274,18,90,10,1,C
220A,220A,2,1441,1480,39,90,10,1,C
220A,220A,2,1572,1692,120,90,10,1,C
220A,220A,2,1717,1746,29,90,10,1,C
220A,220A,2,1765,1848,83,90,10,1,C
220A,220A,2,1880,1910,30,90,10,1,C
220A,220A,2,2018,2035,17,90,10,1,C
220A,220A,2,2628,2692,64,90,10,1,C
220A,220A,2,2715,2747,32,90,10,1,C
220A,220A,2,2755,2839,84,90,10,1,C
220A,220A,2,2858,3000,142,90,10,1,C
220A,220A,15,0,36,36,90,10,1,C
220A,220A,15,56,79,23,90,10,1,C
220A,220A,15,85,122,37,90,10,1,C
220A,220A,15,137,213,76,90,10,1,C
220A,220A,15,226,277,51,90,10,1,C
220A,220A,15,321,350,29,90,10,1,C
220A,220A,15,365,375,10,90,10,1,C
220A,220A,15,390,441,51,90,10,1,C
220A,220A,15,466,519,53,90,10,1,C
220A,220A,15,525,631,106,90,10,1,C
220A,220A,15,689,702,13,90,10,1,C
220A,220A,15,806,878,72,90,10,1,C
220A,220A,15,912,953,41,90,10,1,C
220A,220A,15,960,1104,144,90,10,1,C
220A,220A,15,1150,1182,32,90,10,1,C
220A,220A,15,1191,1210,19,90,10,1,C
220A,220A,15,1234,1273,39,90,10,1,C
220A,220A,15,1281,1296,15,90,10,1,C
220A,220A,15,1374,1419,45,90,10,1,C
220A,220A,15,1456,1496,40,90,10,1,C
220A,220A,15,1516,1533,17,90,10,1,C
220A,220A,15,1566,1625,59,90,10,1,C
220A,220A,15,1633,1648,15,90,10,1,C
220A,220A,15,1671,1713,42,90,10,1,C
220A,220A,15,1791,1833,42,90,10,1,C
220A,220A,15,1888,1915,27,90,10,1,C
220A,220A,15,1929,1982,53,90,10,1,C
220A,220A,15,1987,2005,18,90,10,1,C
220A,220A,15,2031,2106,75,90,10,1,C
220A,220A,15,2120,2130,10,90,10,1,C
220A,220A,15,2161,2245,84,90,10,1,C
220A,220A,15,2327,2374,47,90,10,1,C
220A,220A,15,2441,2516,75,90,10,1,C
220A,220A,15,2643,2662,19,90,10,1,C
220A,220A,15,2708,2732,24,90,10,1,C
220A,220A,15,2761,2781,20,90,10,1,C
220A,220A,15,2812,2825,13,90,10,1,C
220A,220A,15,2857,2879,22,90,10,1,C
220A,220A,15,2902,2917,15,90,10,1,C
220A,220A,15,2952,2970,18,90,10,1,C
220A,220A,28,25,50,25,90,10,1,C
220A,220A,28,98,126,28,90,10,1,C
220A,220A,28,239,276,37,90,10,1,C
220A,220A,28,281,291,10,90,10,1,C
220A,220A,28,300,312,12,90,10,1,C
220A,220A,28,318,345,27,90,10,1,C
220A,220A,28,354,533,179,90,10,1,C
220A,220A,28,610,639,29,90,10,1,C
220A,220A,28,652,670,18,90,10,1,C
220A,220A,28,824,873,49,90,10,1,C
220A,220A,28,880,920,40,90,10,1,C
220A,220A,28,942,965,23,90,10,1,C
220A,220A,28,995,1005,10,90,10,1,C
220A,220A,28,1062,1135,73,90,10,1,C
220A,220A,28,1144,1250,106,90,10,1,C
220A,220A,28,1291,1324,33,90,10,1,C
220A,220A,28,1433,1473,40,90,10,1,C
220A,220A,28,1539,1601,62,90,10,1,C
220A,220A,28,1650,1729,79,90,10,1,C
220A,220A,28,1725,1751,26,90,10,1,C
220A,220A,28,1761,1795,34,90,10,1,C
220A,220A,28,1828,1860,32,90,10,1,C
220A,220A,28,1870,1898,28,90,10,1,C
220A,220A,28,1939,2002,63,90,10,1,C
220A,220A,28,2027,2090,63,90,10,1,C
220A,220A,28,2110,2144,34,90,10,1,C
220A,220A,28,2186,2248,62,90,10,1,C
220A,220A,28,2320,2360,40,90,10,1,C
220A,220A,28,2403,2440,37,90,10,1,C
220A,220A,28,2485,2512,27,90,10,1,C
220A,220A,28,2534,2565,31,90,10,1,C
220A,220A,28,2574,2597,23,90,10,1,C
220A,220A,28,2658,2741,83,90,10,1,C
220A,220A,28,2751,2779,28,90,10,1,C
220A,220A,28,2817,2829,12,90,10,1,C
220A,220A,28,2854,2867,13,90,10,1,C
220A,220A,28,2885,2920,35,90,10,1,C
220A,220A,28,2951,3000,49,90,10,1,C
220G,220G,2,0,36,36,90,10,1,C
220G,220G,2,45,69,24,90,10,1,C
220G,220G,2,74,142,68,90,10,1,C
220G,220G,2,147,192,45,90,10,1,C
220G,220G,2,237,259,22,90,10,1,C
220G,220G,2,266,334,68,90,10,1,C
220G,220G,2,340,390,50,90,10,1,C
220G,220G,2,401,449,48,90,10,1,C
220G,220G,2,456,470,14,90,10,1,C
220G,220G,2,478,505,27,90,10,1,C
220G,220G,2,561,576,15,90,10,1,C
220G,220G,2,582,594,12,90,10,1,C
220G,220G,2,612,676,64,90,10,1,C
220G,220G,2,681,695,14,90,10,1,C
220G,220G,2,700,786,86,90,10,1,C
220G,220G,2,791,903,112,90,10,1,C
220G,220G,2,930,1005,75,90,10,1,C
220G,220G,2,1010,1195,185,90,10,1,C
220G,220G,2,1201,1248,47,90,10,1,C
220G,220G,2,1253,1374,121,90,10,1,C
220G,220G,2,1395,1434,39,90,10,1,C
220G,220G,2,1440,1471,31,90,10,1,C
220G,220G,2,1479,1500,21,90,10,1,C
220G,220G,2,1505,1530,25,90,10,1,C
220G,220G,2,1543,1569,26,90,10,1,C
220G,220G,2,1574,1587,13,90,10,1,C
220G,220G,2,1612,1645,33,90,10,1,C
220G,220G,2,1655,1697,42,90,10,1,C
220G,220G,2,1705,1819,114,90,10,1,C
220G,220G,2,1829,1908,79,90,10,1,C
220G,220G,2,1914,1986,72,90,10,1,C
220G,220G,2,1992,2013,21,90,10,1,C
220G,220G,2,2023,2087,64,90,10,1,C
220G,220G,2,2092,2112,20,90,10,1,C
220G,220G,2,2130,2144,14,90,10,1,C
220G,220G,2,2151,2210,59,90,10,1,C
220G,220G,2,2218,2254,36,90,10,1,C
220G,220G,2,2264,2388,124,90,10,1,C
220G,220G,2,2395,2468,73,90,10,1,C
220G,220G,2,2514,2529,15,90,10,1,C
220G,220G,2,2540,2554,14,90,10,1,C
220G,220G,2,2592,2680,88,90,10,1,C
220G,220G,2,2690,2715,25,90,10,1,C
220G,220G,2,2792,2802,10,90,10,1,C
220G,220G,2,2842,2883,41,90,10,1,C
220G,220G,2,2888,2899,11,90,10,1,C
220G,220G,2,2936,3000,64,90,10,1,C
220G,220G,15,0,21,21,90,10,1,C
220G,220G,15,26,95,69,90,10,1,C
220G,220G,15,105,149,44,90,10,1,C
220G,220G,15,164,174,10,90,10,1,C
220G,220G,15,180,268,88,90,10,1,C
220G,220G,15,291,303,12,90,10,1,C
220G,220G,15,311,366,55,90,10,1,C
220G,220G,15,371,419,48,90,10,1,C
220G,220G,15,444,472,28,90,10,1,C
220G,220G,15,509,530,21,90,10,1,C
220G,220G,15,551,568,17,90,10,1,C
220G,220G,15,572,615,43,90,10,1,C
220G,220G,15,631,655,24,90,10,1,C
220G,220G,15,671,728,57,90,10,1,C
220G,220G,15,764,774,10,90,10,1,C
220G,220G,15,790,845,55,90,10,1,C
220G,220G,15,891,906,15,90,10,1,C
220G,220G,15,1010,1030,20,90,10,1,C
220G,220G,15,1077,1120,43,90,10,1,C
220G,220G,15,1140,1158,18,90,10,1,C
220G,220G,15,1190,1286,96,90,10,1,C
220G,220G,15,1302,1385,83,90,10,1,C
220G,220G,15,1390,1445,55,90,10,1,C
220G,220G,15,1462,1671,209,90,10,1,C
220G,220G,15,1701,1830,129,90,10,1,C
220G,220G,15,1836,1869,33,90,10,1,C
220G,220G,15,1883,2248,365,90,10,1,C
220G,220G,15,2253,2282,29,90,10,1,C
220G,220G,15,2306,2331,25,90,10,1,C
220G,220G,15,2339,2354,15,90,10,1,C
220G,220G,15,2366,2390,24,90,10,1,C
220G,220G,15,2403,2466,63,90,10,1,C
220G,220G,15,2488,2501,13,90,10,1,C
220G,220G,15,2515,2530,15,90,10,1,C
220G,220G,15,2543,2600,57,90,10,1,C
220G,220G,15,2628,2652,24,90,10,1,C
220G,220G,15,2661,2720,59,90,10,1,C
220G,220G,15,2732,2774,42,90,10,1,C
220G,220G,15,2779,2885,106,90,10,1,C
220G,220G,15,2897,2946,49,90,10,1,C
220G,220G,15,2952,2986,34,90,10,1,C
220G,220G,28,7,21,14,90,10,1,C
220G,220G,28,104,173,69,90,10,1,C
220G,220G,28,181,192,11,90,10,1,C
220G,220G,28,246,262,16,90,10,1,C
220G,220G,28,424,437,13,90,10,1,C
220G,220G,28,477,491,14,90,10,1,C
220G,220G,28,496,509,13,90,10,1,C
220G,220G,28,595,621,26,90,10,1,C
220G,220G,28,640,670,30,90,10,1,C
220G,220G,28,681,728,47,90,10,1,C
220G,220G,28,733,790,57,90,10,1,C
220G,220G,28,799,1319,520,90,10,1,C
220G,220G,28,1325,1475,150,90,10,1,C
220G,220G,28,1480,1814,334,90,10,1,C
220G,220G,28,1819,1833,14,90,10,1,C
220G,220G,28,1838,1936,98,90,10,1,C
220G,220G,28,1968,2005,37,90,10,1,C
220G,220G,28,2031,2062,31,90,10,1,C
220G,220G,28,2072,2116,44,90,10,1,C
220G,220G,28,2161,2177,16,90,10,1,C
220G,220G,28,2226,2259,33,90,10,1,C
220G,220G,28,2266,2283,17,90,10,1,C
220G,220G,28,2295,2317,22,90,10,1,C
220G,220G,28,2549,2582,33,90,10,1,C
220G,220G,28,2591,3000,409,90,10,1,C
221A,221A,2,30,44,14,90,10,1,C
221A,221A,2,137,189,52,90,10,1,C
221A,221A,2,223,250,27,90,10,1,C
221A,221A,2,467,501,34,90,10,1,C
221A,221A,2,560,585,25,90,10,1,C
221A,221A,2,596,623,27,90,10,1,C
221A,221A,2,641,695,54,90,10,1,C
221A,221A,2,703,735,32,90,10,1,C
221A,221A,2,818,847,29,90,10,1,C
221A,221A,2,893,931,38,90,10,1,C
221A,221A,2,942,964,22,90,10,1,C
221A,221A,2,988,1007,19,90,10,1,C
221A,221A,2,1045,1081,36,90,10,1,C
221A,221A,2,1108,1142,34,90,10,1,C
221A,221A,2,1151,1167,16,90,10,1,C
221A,221A,2,1222,1253,31,90,10,1,C
221A,221A,2,1303,1327,24,90,10,1,C
221A,221A,2,1350,1367,17,90,10,1,C
221A,221A,2,1374,1394,20,90,10,1,C
221A,221A,2,1475,1542,67,90,10,1,C
221A,221A,2,1630,1679,49,90,10,1,C
221A,221A,2,1715,1747,32,90,10,1,C
221A,221A,2,1795,1835,40,90,10,1,C
221A,221A,2,1993,2040,47,90,10,1,C
221A,221A,2,2070,2083,13,90,10,1,C
221A,221A,2,2276,2298,22,90,10,1,C
221A,221A,2,2419,2474,55,90,10,1,C
221A,221A,2,2512,2546,34,90,10,1,C
221A,221A,2,2608,2633,25,90,10,1,C
221A,221A,2,2704,2744,40,90,10,1,C
221A,221A,2,2758,2808,50,90,10,1,C
221A,221A,2,2813,2831,18,90,10,1,C
221A,221A,2,2851,2865,14,90,10,1,C
221A,221A,15,0,13,13,90,10,1,C
221A,221A,15,56,84,28,90,10,1,C
221A,221A,15,97,120,23,90,10,1,C
221A,221A,15,128,169,41,90,10,1,C
221A,221A,15,175,212,37,90,10,1,C
221A,221A,15,218,231,13,90,10,1,C
221A,221A,15,272,316,44,90,10,1,C
221A,221A,15,321,342,21,90,10,1,C
221A,221A,15,429,450,21,90,10,1,C
221A,221A,15,528,578,50,90,10,1,C
221A,221A,15,650,678,28,90,10,1,C
221A,221A,15,766,805,39,90,10,1,C
221A,221A,15,880,900,20,90,10,1,C
221A,221A,15,947,966,19,90,10,1,C
221A,221A,15,979,994,15,90,10,1,C
221A,221A,15,1120,1146,26,90,10,1,C
221A,221A,15,1170,1185,15,90,10,1,C
221A,221A,15,1207,1230,23,90,10,1,C
221A,221A,15,1276,1299,23,90,10,1,C
221A,221A,15,1321,1332,11,90,10,1,C
221A,221A,15,1374,1406,32,90,10,1,C
221A,221A,15,1437,1464,27,90,10,1,C
221A,221A,15,1496,1524,28,90,10,1,C
221A,221A,15,1579,1605,26,90,10,1,C
221A,221A,15,1620,1650,30,90,10,1,C
221A,221A,15,1713,1745,32,90,10,1,C
221A,221A,15,1788,1818,30,90,10,1,C
221A,221A,15,1843,1875,32,90,10,1,C
221A,221A,15,2024,2097,73,90,10,1,C
221A,221A,15,2127,2173,46,90,10,1,C
221A,221A,15,2218,2241,23,90,10,1,C
221A,221A,15,2323,2335,12,90,10,1,C
221A,221A,15,2363,2381,18,90,10,1,C
221A,221A,15,2395,2437,42,90,10,1,C
221A,221A,15,2484,2527,43,90,10,1,C
221A,221A,15,2541,2564,23,90,10,1,C
221A,221A,15,2571,2585,14,90,10,1,C
221A,221A,15,2642,2674,32,90,10,1,C
221A,221A,15,2719,2747,28,90,10,1,C
221A,221A,15,2928,2953,25,90,10,1,C
221A,221A,15,2988,3000,12,90,10,1,C
221A,221A,28,53,77,24,90,10,1,C
221A,221A,28,133,169,36,90,10,1,C
221A,221A,28,190,205,15,90,10,1,C
221A,221A,28,219,249,30,90,10,1,C
221A,221A,28,288,330,42,90,10,1,C
221A,221A,28,359,416,57,90,10,1,C
221A,221A,28,455,525,70,90,10,1,C
221A,221A,28,562,576,14,90,10,1,C
221A,221A,28,581,633,52,90,10,1,C
221A,221A,28,638,663,25,90,10,1,C
221A,221A,28,690,707,17,90,10,1,C
221A,221A,28,812,876,64,90,10,1,C
221A,221A,28,914,936,22,90,10,1,C
221A,221A,28,960,985,25,90,10,1,C
221A,221A,28,998,1048,50,90,10,1,C
221A,221A,28,1145,1174,29,90,10,1,C
221A,221A,28,1282,1335,53,90,10,1,C
221A,221A,28,1368,1395,27,90,10,1,C
221A,221A,28,1450,1466,16,90,10,1,C
221A,221A,28,1504,1526,22,90,10,1,C
221A,221A,28,1698,1724,26,90,10,1,C
221A,221A,28,1750,1796,46,90,10,1,C
221A,221A,28,1913,1989,76,90,10,1,C
221A,221A,28,2029,2053,24,90,10,1,C
221A,221A,28,2116,2140,24,90,10,1,C
221A,221A,28,2162,2202,40,90,10,1,C
221A,221A,28,2225,2257,32,90,10,1,C
221A,221A,28,2277,2303,26,90,10,1,C
221A,221A,28,2323,2333,10,90,10,1,C
221A,221A,28,2370,2404,34,90,10,1,C
221A,221A,28,2417,2475,58,90,10,1,C
221A,221A,28,2548,2601,53,90,10,1,C
221A,221A,28,2616,2657,41,90,10,1,C
221A,221A,28,2705,2753,48,90,10,1,C
221A,221A,28,2786,2835,49,90,10,1,C
221A,221A,28,2878,2923,45,90,10,1,C
221A,221A,28,2981,3000,19,90,10,1,C
221G,221G,2,108,122,14,90,10,1,C
221G,221G,2,160,187,27,90,10,1,C
221G,221G,2,192,224,32,90,10,1,C
221G,221G,2,321,336,15,90,10,1,C
221G,221G,2,387,445,58,90,10,1,C
221G,221G,2,502,561,59,90,10,1,C
221G,221G,2,616,641,25,90,10,1,C
221G,221G,2,740,785,45,90,10,1,C
221G,221G,2,1742,1771,29,90,10,1,C
221G,221G,2,2321,2340,19,90,10,1,C
221G,221G,2,2522,2540,18,90,10,1,C
221G,221G,2,2825,2860,35,90,10,1,C
221G,221G,2,2933,3000,67,90,10,1,C
221G,221G,15,66,96,30,90,10,1,C
221G,221G,15,214,250,36,90,10,1,C
221G,221G,15,304,322,18,90,10,1,C
221G,221G,15,470,486,16,90,10,1,C
221G,221G,15,527,538,11,90,10,1,C
221G,221G,15,708,743,35,90,10,1,C
221G,221G,15,815,841,26,90,10,1,C
221G,221G,15,1045,1086,41,90,10,1,C
221G,221G,15,1101,1117,16,90,10,1,C
221G,221G,15,1739,1769,30,90,10,1,C
221G,221G,15,2017,2034,17,90,10,1,C
221G,221G,15,2200,2260,60,90,10,1,C
221G,221G,15,2494,2512,18,90,10,1,C
221G,221G,15,2554,2565,11,90,10,1,C
221G,221G,15,2581,2605,24,90,10,1,C
221G,221G,28,0,29,29,90,10,1,C
221G,221G,28,73,91,18,90,10,1,C
221G,221G,28,113,134,21,90,10,1,C
221G,221G,28,206,235,29,90,10,1,C
221G,221G,28,249,273,24,90,10,1,C
221G,221G,28,377,390,13,90,10,1,C
221G,221G,28,447,483,36,90,10,1,C
221G,221G,28,591,610,19,90,10,1,C
221G,221G,28,813,839,26,90,10,1,C
221G,221G,28,1136,1156,20,90,10,1,C
221G,221G,28,1188,1209,21,90,10,1,C
221G,221G,28,1301,1326,25,90,10,1,C
221G,221G,28,1336,1353,17,90,10,1,C
221G,221G,28,1749,1767,18,90,10,1,C
221G,221G,28,2007,2045,38,90,10,1,C
221G,221G,28,2080,2099,19,90,10,1,C
221G,221G,28,2261,2282,21,90,10,1,C
221G,221G,28,2439,2452,13,90,10,1,C
221G,221G,28,2547,2566,19,90,10,1,C
221G,221G,28,2588,2607,19,90,10,1,C
221G,221G,28,2639,2668,29,90,10,1,C
221G,221G,28,2686,2703,17,90,10,1,C
221G,221G,28,2839,2852,13,90,10,1,C
221G,221G,28,2881,2892,11,90,10,1,C
222A,222A,2,0,60,60,90,10,1,C
222A,222A,2,65,112,47,90,10,1,C
222A,222A,2,123,161,38,90,10,1,C
222A,222A,2,220,260,40,90,10,1,C
222A,222A,2,290,300,10,90,10,1,C
222A,222A,2,448,494,46,90,10,1,C
222A,222A,2,502,519,17,90,10,1,C
222A,222A,2,634,706,72,90,10,1,C
222A,222A,2,748,805,57,90,10,1,C
222A,222A,2,821,832,11,90,10,1,C
222A,222A,2,843,981,138,90,10,1,C
222A,222A,2,986,1000,14,90,10,1,C
222A,222A,2,1030,1045,15,90,10,1,C
222A,222A,2,1051,1102,51,90,10,1,C
222A,222A,2,1233,1245,12,90,10,1,C
222A,222A,2,2035,2061,26,90,10,1,C
222A,222A,2,2090,2111,21,90,10,1,C
222A,222A,2,2133,2173,40,90,10,1,C
222A,222A,2,2180,2195,15,90,10,1,C
222A,222A,2,2222,2249,27,90,10,1,C
222A,222A,2,2261,2271,10,90,10,1,C
222A,222A,2,2697,2725,28,90,10,1,C
222A,222A,2,2822,2846,24,90,10,1,C
222A,222A,15,10,86,76,90,10,1,C
222A,222A,15,93,113,20,90,10,1,C
222A,222A,15,120,176,56,90,10,1,C
222A,222A,15,192,208,16,90,10,1,C
222A,222A,15,217,280,63,90,10,1,C
222A,222A,15,322,367,45,90,10,1,C
222A,222A,15,395,412,17,90,10,1,C
222A,222A,15,417,444,27,90,10,1,C
222A,222A,15,468,485,17,90,10,1,C
222A,222A,15,500,515,15,90,10,1,C
222A,222A,15,532,566,34,90,10,1,C
222A,222A,15,579,602,23,90,10,1,C
222A,222A,15,616,636,20,90,10,1,C
222A,222A,15,676,714,38,90,10,1,C
222A,222A,15,727,790,63,90,10,1,C
222A,222A,15,798,829,31,90,10,1,C
222A,222A,15,835,930,95,90,10,1,C
222A,222A,15,972,984,12,90,10,1,C
222A,222A,15,993,1016,23,90,10,1,C
222A,222A,15,1032,1067,35,90,10,1,C
222A,222A,15,1273,1432,159,90,10,1,C
222A,222A,15,1444,1515,71,90,10,1,C
222A,222A,15,1525,1586,61,90,10,1,C
222A,222A,15,1641,1674,33,90,10,1,C
222A,222A,15,1691,1748,57,90,10,1,C
222A,222A,15,1770,1781,11,90,10,1,C
222A,222A,15,1787,1830,43,90,10,1,C
222A,222A,15,1842,1853,11,90,10,1,C
222A,222A,15,1869,1907,38,90,10,1,C
222A,222A,15,1916,1931,15,90,10,1,C
222A,222A,15,1940,1970,30,90,10,1,C
222A,222A,15,1990,2004,14,90,10,1,C
222A,222A,15,2020,2062,42,90,10,1,C
222A,222A,15,2133,2143,10,90,10,1,C
222A,222A,15,2223,2236,13,90,10,1,C
222A,222A,15,2324,2387,63,90,10,1,C
222A,222A,15,2415,2498,83,90,10,1,C
222A,222A,15,2563,2616,53,90,10,1,C
222A,222A,15,2648,2700,52,90,10,1,C
222A,222A,15,2736,2771,35,90,10,1,C
222A,222A,15,2820,2832,12,90,10,1,C
222A,222A,15,2845,2861,16,90,10,1,C
222A,222A,15,2893,2910,17,90,10,1,C
222A,222A,15,2953,2974,21,90,10,1,C
222A,222A,28,9,85,76,90,10,1,C
222A,222A,28,110,234,124,90,10,1,C
222A,222A,28,268,397,129,90,10,1,C
222A,222A,28,551,588,37,90,10,1,C
222A,222A,28,607,637,30,90,10,1,C
222A,222A,28,691,706,15,90,10,1,C
222A,222A,28,873,896,23,90,10,1,C
222A,222A,28,901,961,60,90,10,1,C
222A,222A,28,970,984,14,90,10,1,C
222A,222A,28,996,1018,22,90,10,1,C
222A,222A,28,1179,1190,11,90,10,1,C
222A,222A,28,1267,1304,37,90,10,1,C
222A,222A,28,1390,1412,22,90,10,1,C
222A,222A,28,1444,1491,47,90,10,1,C
222A,222A,28,1551,1597,46,90,10,1,C
222A,222A,28,1602,1624,22,90,10,1,C
222A,222A,28,1681,1720,39,90,10,1,C
222A,222A,28,1751,1850,99,90,10,1,C
222A,222A,28,1895,1927,32,90,10,1,C
222A,222A,28,2008,2061,53,90,10,1,C
222A,222A,28,2073,2097,24,90,10,1,C
222A,222A,28,2110,2122,12,90,10,1,C
222A,222A,28,2131,2180,49,90,10,1,C
222A,222A,28,2234,2281,47,90,10,1,C
222A,222A,28,2339,2384,45,90,10,1,C
222A,222A,28,2461,2496,35,90,10,1,C
222A,222A,28,2523,2582,59,90,10,1,C
222A,222A,28,2640,2656,16,90,10,1,C
222A,222A,28,2680,2717,37,90,10,1,C
222A,222A,28,2750,2806,56,90,10,1,C
222A,222A,28,2834,2849,15,90,10,1,C
222A,222A,28,2880,3000,120,90,10,1,C
222G,222G,2,0,35,35,90,10,1,C
222G,222G,2,49,82,33,90,10,1,C
222G,222G,2,108,132,24,90,10,1,C
222G,222G,2,149,235,86,90,10,1,C
222G,222G,2,246,280,34,90,10,1,C
222G,222G,2,295,308,13,90,10,1,C
222G,222G,2,316,387,71,90,10,1,C
222G,222G,2,395,431,36,90,10,1,C
222G,222G,2,444,488,44,90,10,1,C
222G,222G,2,493,534,41,90,10,1,C
222G,222G,2,539,650,111,90,10,1,C
222G,222G,2,664,703,39,90,10,1,C
222G,222G,2,728,742,14,90,10,1,C
222G,222G,2,758,819,61,90,10,1,C
222G,222G,2,870,917,47,90,10,1,C
222G,222G,2,976,1003,27,90,10,1,C
222G,222G,2,1145,1167,22,90,10,1,C
222G,222G,2,1179,1194,15,90,10,1,C
222G,222G,2,1203,1300,97,90,10,1,C
222G,222G,2,1329,1368,39,90,10,1,C
222G,222G,2,1447,1555,108,90,10,1,C
222G,222G,2,1563,1583,20,90,10,1,C
222G,222G,2,1617,1781,164,90,10,1,C
222G,222G,2,1796,1895,99,90,10,1,C
222G,222G,2,1919,2000,81,90,10,1,C
222G,222G,2,2034,2131,97,90,10,1,C
222G,222G,2,2144,2252,108,90,10,1,C
222G,222G,2,2257,2427,170,90,10,1,C
222G,222G,2,2446,2505,59,90,10,1,C
222G,222G,2,2540,2566,26,90,10,1,C
222G,222G,2,2570,2637,67,90,10,1,C
222G,222G,2,2642,2657,15,90,10,1,C
222G,222G,2,2692,2878,186,90,10,1,C
222G,222G,2,2883,2968,85,90,10,1,C
222G,222G,15,0,45,45,90,10,1,C
222G,222G,15,71,119,48,90,10,1,C
222G,222G,15,145,163,18,90,10,1,C
222G,222G,15,173,216,43,90,10,1,C
222G,222G,15,221,556,335,90,10,1,C
222G,222G,15,561,719,158,90,10,1,C
222G,222G,15,723,771,48,90,10,1,C
222G,222G,15,825,843,18,90,10,1,C
222G,222G,15,940,1077,137,90,10,1,C
222G,222G,15,1092,1265,173,90,10,1,C
222G,222G,15,1295,1344,49,90,10,1,C
222G,222G,15,1355,1399,44,90,10,1,C
222G,222G,15,1403,1437,34,90,10,1,C
222G,222G,15,1445,1472,27,90,10,1,C
222G,222G,15,1477,1503,26,90,10,1,C
222G,222G,15,1508,1546,38,90,10,1,C
222G,222G,15,1544,1569,25,90,10,1,C
222G,222G,15,1581,1683,102,90,10,1,C
222G,222G,15,1691,1701,10,90,10,1,C
222G,222G,15,1706,1726,20,90,10,1,C
222G,222G,15,1737,1802,65,90,10,1,C
222G,222G,15,1850,1882,32,90,10,1,C
222G,222G,15,1887,1910,23,90,10,1,C
222G,222G,15,2025,2049,24,90,10,1,C
222G,222G,15,2054,2069,15,90,10,1,C
222G,222G,15,2076,2154,78,90,10,1,C
222G,222G,15,2168,2244,76,90,10,1,C
222G,222G,15,2255,2311,56,90,10,1,C
222G,222G,15,2316,2365,49,90,10,1,C
222G,222G,15,2370,2408,38,90,10,1,C
222G,222G,15,2449,2517,68,90,10,1,C
222G,222G,15,2527,2545,18,90,10,1,C
222G,222G,15,2600,2642,42,90,10,1,C
222G,222G,15,2748,2828,80,90,10,1,C
222G,222G,15,2853,2892,39,90,10,1,C
222G,222G,15,2908,2927,19,90,10,1,C
222G,222G,15,2961,2990,29,90,10,1,C
222G,222G,28,0,15,15,90,10,1,C
222G,222G,28,21,177,156,90,10,1,C
222G,222G,28,208,254,46,90,10,1,C
222G,222G,28,281,321,40,90,10,1,C
222G,222G,28,331,362,31,90,10,1,C
222G,222G,28,405,455,50,90,10,1,C
222G,222G,28,467,481,14,90,10,1,C
222G,222G,28,489,537,48,90,10,1,C
222G,222G,28,557,607,50,90,10,1,C
222G,222G,28,653,690,37,90,10,1,C
222G,222G,28,765,825,60,90,10,1,C
222G,222G,28,850,988,138,90,10,1,C
222G,222G,28,1005,1048,43,90,10,1,C
222G,222G,28,1060,1180,120,90,10,1,C
222G,222G,28,1186,1330,144,90,10,1,C
222G,222G,28,1353,1392,39,90,10,1,C
222G,222G,28,1412,1463,51,90,10,1,C
222G,222G,28,1486,1595,109,90,10,1,C
222G,222G,28,1617,1665,48,90,10,1,C
222G,222G,28,1696,1741,45,90,10,1,C
222G,222G,28,1773,1909,136,90,10,1,C
222G,222G,28,1938,2010,72,90,10,1,C
222G,222G,28,2019,2077,58,90,10,1,C
222G,222G,28,2105,2152,47,90,10,1,C
222G,222G,28,2165,2185,20,90,10,1,C
222G,222G,28,2208,2274,66,90,10,1,C
222G,222G,28,2311,2400,89,90,10,1,C
222G,222G,28,2408,2430,22,90,10,1,C
222G,222G,28,2437,2455,18,90,10,1,C
222G,222G,28,2486,2501,15,90,10,1,C
222G,222G,28,2541,2634,93,90,10,1,C
222G,222G,28,2656,2679,23,90,10,1,C
222G,222G,28,2689,2737,48,90,10,1,C
222G,222G,28,2752,2785,33,90,10,1,C
222G,222G,28,2790,2930,140,90,10,1,C
222G,222G,28,2943,2974,31,90,10,1,C
222G,222G,28,2981,2995,14,90,10,1,C
223A,223A,2,8,40,32,90,10,1,C
223A,223A,2,47,138,91,90,10,1,C
223A,223A,2,205,285,80,90,10,1,C
223A,223A,2,292,375,83,90,10,1,C
223A,223A,2,395,430,35,90,10,1,C
223A,223A,2,440,450,10,90,10,1,C
223A,223A,2,483,517,34,90,10,1,C
223A,223A,2,550,604,54,90,10,1,C
223A,223A,2,675,715,40,90,10,1,C
223A,223A,2,747,790,43,90,10,1,C
223A,223A,2,836,870,34,90,10,1,C
223A,223A,2,900,920,20,90,10,1,C
223A,223A,2,935,965,30,90,10,1,C
223A,223A,2,992,1053,61,90,10,1,C
223A,223A,2,1079,1118,39,90,10,1,C
223A,223A,2,1123,1133,10,90,10,1,C
223A,223A,2,1142,1252,110,90,10,1,C
223A,223A,2,1275,1307,32,90,10,1,C
223A,223A,2,1312,1339,27,90,10,1,C
223A,223A,2,1400,1441,41,90,10,1,C
223A,223A,2,1483,1597,114,90,10,1,C
223A,223A,2,1630,1667,37,90,10,1,C
223A,223A,2,1759,1799,40,90,10,1,C
223A,223A,2,1850,1870,20,90,10,1,C
223A,223A,2,1874,1930,56,90,10,1,C
223A,223A,2,1935,1955,20,90,10,1,C
223A,223A,2,1967,1980,13,90,10,1,C
223A,223A,2,2000,2021,21,90,10,1,C
223A,223A,2,2072,2110,38,90,10,1,C
223A,223A,2,2139,2164,25,90,10,1,C
223A,223A,2,2175,2284,109,90,10,1,C
223A,223A,2,2295,2343,48,90,10,1,C
223A,223A,2,2440,2501,61,90,10,1,C
223A,223A,2,2517,2587,70,90,10,1,C
223A,223A,2,2620,2697,77,90,10,1,C
223A,223A,2,2709,2723,14,90,10,1,C
223A,223A,2,2780,2806,26,90,10,1,C
223A,223A,2,2820,2893,73,90,10,1,C
223A,223A,2,2983,3000,17,90,10,1,C
223A,223A,15,5,30,25,90,10,1,C
223A,223A,15,55,220,165,90,10,1,C
223A,223A,15,293,310,17,90,10,1,C
223A,223A,15,352,388,36,90,10,1,C
223A,223A,15,403,539,136,90,10,1,C
223A,223A,15,559,601,42,90,10,1,C
223A,223A,15,608,700,92,90,10,1,C
223A,223A,15,707,722,15,90,10,1,C
223A,223A,15,785,841,56,90,10,1,C
223A,223A,15,850,861,11,90,10,1,C
223A,223A,15,900,910,10,90,10,1,C
223A,223A,15,920,939,19,90,10,1,C
223A,223A,15,952,968,16,90,10,1,C
223A,223A,15,1034,1074,40,90,10,1,C
223A,223A,15,1128,1153,25,90,10,1,C
223A,223A,15,1161,1175,14,90,10,1,C
223A,223A,15,1202,1236,34,90,10,1,C
223A,223A,15,1252,1284,32,90,10,1,C
223A,223A,15,1310,1340,30,90,10,1,C
223A,223A,15,1347,1400,53,90,10,1,C
223A,223A,15,1405,1424,19,90,10,1,C
223A,223A,15,1441,1470,29,90,10,1,C
223A,223A,15,1542,1579,37,90,10,1,C
223A,223A,15,1630,1659,29,90,10,1,C
223A,223A,15,1666,1698,32,90,10,1,C
223A,223A,15,1707,1735,28,90,10,1,C
223A,223A,15,1745,1756,11,90,10,1,C
223A,223A,15,1850,1860,10,90,10,1,C
223A,223A,15,1889,1927,38,90,10,1,C
223A,223A,15,1994,2015,21,90,10,1,C
223A,223A,15,2096,2111,15,90,10,1,C
223A,223A,15,2169,2202,33,90,10,1,C
223A,223A,15,2211,2240,29,90,10,1,C
223A,223A,15,2274,2360,86,90,10,1,C
223A,223A,15,2371,2462,91,90,10,1,C
223A,223A,15,2478,2500,22,90,10,1,C
223A,223A,15,2549,2594,45,90,10,1,C
223A,223A,15,2615,2710,95,90,10,1,C
223A,223A,15,2764,2819,55,90,10,1,C
223A,223A,15,2845,2963,118,90,10,1,C
223A,223A,15,2990,3000,10,90,10,1,C
223A,223A,28,0,45,45,90,10,1,C
223A,223A,28,55,81,26,90,10,1,C
223A,223A,28,91,184,93,90,10,1,C
223A,223A,28,228,250,22,90,10,1,C
223A,223A,28,295,353,58,90,10,1,C
223A,223A,28,375,420,45,90,10,1,C
223A,223A,28,435,493,58,90,10,1,C
223A,223A,28,505,550,45,90,10,1,C
223A,223A,28,566,626,60,90,10,1,C
223A,223A,28,640,664,24,90,10,1,C
223A,223A,28,683,715,32,90,10,1,C
223A,223A,28,748,768,20,90,10,1,C
223A,223A,28,810,839,29,90,10,1,C
223A,223A,28,848,858,10,90,10,1,C
223A,223A,28,929,942,13,90,10,1,C
223A,223A,28,949,992,43,90,10,1,C
223A,223A,28,1007,1020,13,90,10,1,C
223A,223A,28,1095,1225,130,90,10,1,C
223A,223A,28,1231,1261,30,90,10,1,C
223A,223A,28,1271,1312,41,90,10,1,C
223A,223A,28,1330,1373,43,90,10,1,C
223A,223A,28,1387,1402,15,90,10,1,C
223A,223A,28,1505,1555,50,90,10,1,C
223A,223A,28,1568,1624,56,90,10,1,C
223A,223A,28,1660,1702,42,90,10,1,C
223A,223A,28,1767,1819,52,90,10,1,C
223A,223A,28,1848,1901,53,90,10,1,C
223A,223A,28,1920,2022,102,90,10,1,C
223A,223A,28,2028,2090,62,90,10,1,C
223A,223A,28,2107,2186,79,90,10,1,C
223A,223A,28,2197,2228,31,90,10,1,C
223A,223A,28,2261,2288,27,90,10,1,C
223A,223A,28,2294,2353,59,90,10,1,C
223A,223A,28,2454,2537,83,90,10,1,C
223A,223A,28,2575,2614,39,90,10,1,C
223A,223A,28,2633,2646,13,90,10,1,C
223A,223A,28,2652,2665,13,90,10,1,C
223A,223A,28,2706,2732,26,90,10,1,C
223A,223A,28,2737,2752,15,90,10,1,C
223A,223A,28,2757,2791,34,90,10,1,C
223A,223A,28,2797,2821,24,90,10,1,C
223A,223A,28,2896,2920,24,90,10,1,C
223A,223A,28,2926,2947,21,90,10,1,C
223G,223G,2,32,68,36,90,10,1,C
223G,223G,2,94,124,30,90,10,1,C
223G,223G,2,135,167,32,90,10,1,C
223G,223G,2,200,213,13,90,10,1,C
223G,223G,2,770,812,42,90,10,1,C
223G,223G,2,858,931,73,90,10,1,C
223G,223G,2,992,1040,48,90,10,1,C
223G,223G,15,0,94,94,90,10,1,C
223G,223G,15,123,227,104,90,10,1,C
223G,223G,15,630,681,51,90,10,1,C
223G,223G,15,733,758,25,90,10,1,C
223G,223G,15,801,835,34,90,10,1,C
223G,223G,15,868,902,34,90,10,1,C
223G,223G,15,918,1001,83,90,10,1,C
223G,223G,15,1127,1140,13,90,10,1,C
223G,223G,15,1320,1343,23,90,10,1,C
223G,223G,15,1368,1391,23,90,10,1,C
223G,223G,15,1579,1653,74,90,10,1,C
223G,223G,15,1965,1999,34,90,10,1,C
223G,223G,15,2091,2111,20,90,10,1,C
223G,223G,15,2281,2313,32,90,10,1,C
223G,223G,15,2371,2397,26,90,10,1,C
223G,223G,15,2502,2552,50,90,10,1,C
223G,223G,28,93,128,35,90,10,1,C
223G,223G,28,235,275,40,90,10,1,C
223G,223G,28,413,436,23,90,10,1,C
223G,223G,28,718,738,20,90,10,1,C
223G,223G,28,798,820,22,90,10,1,C
223G,223G,28,990,1067,77,90,10,1,C
223G,223G,28,1251,1283,32,90,10,1,C
223G,223G,28,1327,1351,24,90,10,1,C
223G,223G,28,1367,1387,20,90,10,1,C
223G,223G,28,1503,1513,10,90,10,1,C
223G,223G,28,1574,1603,29,90,10,1,C
223G,223G,28,1700,1714,14,90,10,1,C
223G,223G,28,1980,2011,31,90,10,1,C
223G,223G,28,2091,2109,18,90,10,1,C
223G,223G,28,2456,2476,20,90,10,1,C
223G,223G,28,2653,2674,21,90,10,1,C
223G,223G,28,2813,2832,19,90,10,1,C
223G,223G,28,2865,2892,27,90,10,1,C
223G,223G,28,2929,2955,26,90,10,1,C
223G,223G,28,2970,2988,18,90,10,1,C
224A,224A,2,0,15,15,90,10,1,C
224A,224A,2,25,46,21,90,10,1,C
224A,224A,2,66,100,34,90,10,1,C
224A,224A,2,149,185,36,90,10,1,C
224A,224A,2,231,274,43,90,10,1,C
224A,224A,2,293,309,16,90,10,1,C
224A,224A,2,360,388,28,90,10,1,C
224A,224A,2,420,460,40,90,10,1,C
224A,224A,2,470,507,37,90,10,1,C
224A,224A,2,562,608,46,90,10,1,C
224A,224A,2,617,646,29,90,10,1,C
224A,224A,2,681,705,24,90,10,1,C
224A,224A,2,710,728,18,90,10,1,C
224A,224A,2,745,772,27,90,10,1,C
224A,224A,2,824,845,21,90,10,1,C
224A,224A,2,859,875,16,90,10,1,C
224A,224A,2,900,914,14,90,10,1,C
224A,224A,2,925,936,11,90,10,1,C
224A,224A,2,942,961,19,90,10,1,C
224A,224A,2,970,985,15,90,10,1,C
224A,224A,2,1004,1091,87,90,10,1,C
224A,224A,2,1123,1183,60,90,10,1,C
224A,224A,2,1303,1339,36,90,10,1,C
224A,224A,2,1440,1510,70,90,10,1,C
224A,224A,2,1530,1584,54,90,10,1,C
224A,224A,2,1593,1605,12,90,10,1,C
224A,224A,2,1641,1665,24,90,10,1,C
224A,224A,2,1670,1682,12,90,10,1,C
224A,224A,2,1690,1708,18,90,10,1,C
224A,224A,2,1880,1895,15,90,10,1,C
224A,224A,2,1906,1930,24,90,10,1,C
224A,224A,2,1968,2011,43,90,10,1,C
224A,224A,2,2041,2067,26,90,10,1,C
224A,224A,2,2146,2162,16,90,10,1,C
224A,224A,2,2202,2248,46,90,10,1,C
224A,224A,2,2292,2353,61,90,10,1,C
224A,224A,2,2374,2447,73,90,10,1,C
224A,224A,2,2483,2509,26,90,10,1,C
224A,224A,2,2553,2572,19,90,10,1,C
224A,224A,2,2598,2628,30,90,10,1,C
224A,224A,2,2640,2651,11,90,10,1,C
224A,224A,2,2694,2721,27,90,10,1,C
224A,224A,2,2755,2785,30,90,10,1,C
224A,224A,2,2791,2820,29,90,10,1,C
224A,224A,2,2860,2894,34,90,10,1,C
224A,224A,2,2957,2984,27,90,10,1,C
224A,224A,15,17,41,24,90,10,1,C
224A,224A,15,61,91,30,90,10,1,C
224A,224A,15,107,141,34,90,10,1,C
224A,224A,15,179,197,18,90,10,1,C
224A,224A,15,215,267,52,90,10,1,C
224A,224A,15,314,346,32,90,10,1,C
224A,224A,15,354,365,11,90,10,1,C
224A,224A,15,372,415,43,90,10,1,C
224A,224A,15,430,455,25,90,10,1,C
224A,224A,15,475,541,66,90,10,1,C
224A,224A,15,625,635,10,90,10,1,C
224A,224A,15,650,665,15,90,10,1,C
224A,224A,15,694,708,14,90,10,1,C
224A,224A,15,753,763,10,90,10,1,C
224A,224A,15,768,787,19,90,10,1,C
224A,224A,15,879,901,22,90,10,1,C
224A,224A,15,1005,1040,35,90,10,1,C
224A,224A,15,1127,1152,25,90,10,1,C
224A,224A,15,1240,1257,17,90,10,1,C
224A,224A,15,1279,1312,33,90,10,1,C
224A,224A,15,1331,1344,13,90,10,1,C
224A,224A,15,1358,1382,24,90,10,1,C
224A,224A,15,1464,1489,25,90,10,1,C
224A,224A,15,1545,1558,13,90,10,1,C
224A,224A,15,1568,1625,57,90,10,1,C
224A,224A,15,1633,1694,61,90,10,1,C
224A,224A,15,1702,1721,19,90,10,1,C
224A,224A,15,1729,1751,22,90,10,1,C
224A,224A,15,1763,1783,20,90,10,1,C
224A,224A,15,1814,1825,11,90,10,1,C
224A,224A,15,1919,1955,36,90,10,1,C
224A,224A,15,2075,2188,113,90,10,1,C
224A,224A,15,2219,2282,63,90,10,1,C
224A,224A,15,2337,2370,33,90,10,1,C
224A,224A,15,2380,2396,16,90,10,1,C
224A,224A,15,2402,2416,14,90,10,1,C
224A,224A,15,2427,2451,24,90,10,1,C
224A,224A,15,2463,2491,28,90,10,1,C
224A,224A,15,2497,2516,19,90,10,1,C
224A,224A,15,2604,2686,82,90,10,1,C
224A,224A,15,2725,2741,16,90,10,1,C
224A,224A,15,2782,2795,13,90,10,1,C
224A,224A,15,2882,2950,68,90,10,1,C
224A,224A,15,2953,2995,42,90,10,1,C
224A,224A,28,55,134,79,90,10,1,C
224A,224A,28,207,242,35,90,10,1,C
224A,224A,28,394,430,36,90,10,1,C
224A,224A,28,442,491,49,90,10,1,C
224A,224A,28,550,643,93,90,10,1,C
224A,224A,28,674,710,36,90,10,1,C
224A,224A,28,726,736,10,90,10,1,C
224A,224A,28,791,809,18,90,10,1,C
224A,224A,28,861,886,25,90,10,1,C
224A,224A,28,951,970,19,90,10,1,C
224A,224A,28,1029,1086,57,90,10,1,C
224A,224A,28,1241,1268,27,90,10,1,C
224A,224A,28,1277,1302,25,90,10,1,C
224A,224A,28,1307,1319,12,90,10,1,C
224A,224A,28,1328,1354,26,90,10,1,C
224A,224A,28,1385,1437,52,90,10,1,C
224A,224A,28,1446,1459,13,90,10,1,C
224A,224A,28,1468,1483,15,90,10,1,C
224A,224A,28,1552,1572,20,90,10,1,C
224A,224A,28,1585,1646,61,90,10,1,C
224A,224A,28,1660,1680,20,90,10,1,C
224A,224A,28,1688,1761,73,90,10,1,C
224A,224A,28,1906,1967,61,90,10,1,C
224A,224A,28,2010,2046,36,90,10,1,C
224A,224A,28,2055,2118,63,90,10,1,C
224A,224A,28,2123,2145,22,90,10,1,C
224A,224A,28,2153,2165,12,90,10,1,C
224A,224A,28,2184,2224,40,90,10,1,C
224A,224A,28,2302,2349,47,90,10,1,C
224A,224A,28,2385,2415,30,90,10,1,C
224A,224A,28,2433,2445,12,90,10,1,C
224A,224A,28,2472,2485,13,90,10,1,C
224A,224A,28,2493,2516,23,90,10,1,C
224A,224A,28,2553,2585,32,90,10,1,C
224A,224A,28,2605,2633,28,90,10,1,C
224A,224A,28,2804,2845,41,90,10,1,C
224A,224A,28,2857,2897,40,90,10,1,C
224A,224A,28,2918,2941,23,90,10,1,C
224A,224A,28,2987,3000,13,90,10,1,C
224G,224G,2,0,51,51,90,10,1,C
224G,224G,2,60,82,22,90,10,1,C
224G,224G,2,111,131,20,90,10,1,C
224G,224G,2,142,244,102,90,10,1,C
224G,224G,2,297,328,31,90,10,1,C
224G,224G,2,333,367,34,90,10,1,C
224G,224G,2,387,405,18,90,10,1,C
224G,224G,2,420,494,74,90,10,1,C
224G,224G,2,505,529,24,90,10,1,C
224G,224G,2,553,576,23,90,10,1,C
224G,224G,2,598,623,25,90,10,1,C
224G,224G,2,634,661,27,90,10,1,C
224G,224G,2,678,702,24,90,10,1,C
224G,224G,2,778,828,50,90,10,1,C
224G,224G,2,853,1114,261,90,10,1,C
224G,224G,2,1129,1147,18,90,10,1,C
224G,224G,2,1160,1178,18,90,10,1,C
224G,224G,2,1194,1216,22,90,10,1,C
224G,224G,2,1229,1258,29,90,10,1,C
224G,224G,2,1298,1348,50,90,10,1,C
224G,224G,2,1364,1436,72,90,10,1,C
224G,224G,2,1441,1461,20,90,10,1,C
224G,224G,2,1470,1485,15,90,10,1,C
224G,224G,2,1509,1530,21,90,10,1,C
224G,224G,2,1558,1625,67,90,10,1,C
224G,224G,2,1641,1673,32,90,10,1,C
224G,224G,2,1684,1741,57,90,10,1,C
224G,224G,2,1753,1796,43,90,10,1,C
224G,224G,2,1889,1902,13,90,10,1,C
224G,224G,2,1909,1936,27,90,10,1,C
224G,224G,2,1954,1981,27,90,10,1,C
224G,224G,2,2008,2055,47,90,10,1,C
224G,224G,2,2060,2116,56,90,10,1,C
224G,224G,2,2192,2213,21,90,10,1,C
224G,224G,2,2219,2245,26,90,10,1,C
224G,224G,2,2320,2344,24,90,10,1,C
224G,224G,2,2365,2435,70,90,10,1,C
224G,224G,2,2441,2508,67,90,10,1,C
224G,224G,2,2524,2540,16,90,10,1,C
224G,224G,2,2551,2625,74,90,10,1,C
224G,224G,2,2647,2722,75,90,10,1,C
224G,224G,2,2727,2767,40,90,10,1,C
224G,224G,2,2774,2796,22,90,10,1,C
224G,224G,2,2854,2878,24,90,10,1,C
224G,224G,2,2915,2983,68,90,10,1,C
224G,224G,2,2988,3000,12,90,10,1,C
224G,224G,15,125,141,16,90,10,1,C
224G,224G,15,174,205,31,90,10,1,C
224G,224G,15,211,266,55,90,10,1,C
224G,224G,15,294,346,52,90,10,1,C
224G,224G,15,430,456,26,90,10,1,C
224G,224G,15,775,870,95,90,10,1,C
224G,224G,15,887,914,27,90,10,1,C
224G,224G,15,922,982,60,90,10,1,C
224G,224G,15,989,1019,30,90,10,1,C
224G,224G,15,1025,1043,18,90,10,1,C
224G,224G,15,1048,1079,31,90,10,1,C
224G,224G,15,1088,1154,66,90,10,1,C
224G,224G,15,1159,1218,59,90,10,1,C
224G,224G,15,1223,1260,37,90,10,1,C
224G,224G,15,1265,1304,39,90,10,1,C
224G,224G,15,1311,1331,20,90,10,1,C
224G,224G,15,1376,1430,54,90,10,1,C
224G,224G,15,1459,1507,48,90,10,1,C
224G,224G,15,1514,1547,33,90,10,1,C
224G,224G,15,1566,1585,19,90,10,1,C
224G,224G,15,1606,1641,35,90,10,1,C
224G,224G,15,1685,1711,26,90,10,1,C
224G,224G,15,1728,1790,62,90,10,1,C
224G,224G,15,1798,1867,69,90,10,1,C
224G,224G,15,1890,2017,127,90,10,1,C
224G,224G,15,2051,2088,37,90,10,1,C
224G,224G,15,2121,2137,16,90,10,1,C
224G,224G,15,2167,2198,31,90,10,1,C
224G,224G,15,2205,2460,255,90,10,1,C
224G,224G,15,2473,2486,13,90,10,1,C
224G,224G,15,2534,2564,30,90,10,1,C
224G,224G,15,2581,2656,75,90,10,1,C
224G,224G,15,2661,2732,71,90,10,1,C
224G,224G,15,2737,2790,53,90,10,1,C
224G,224G,15,2806,2916,110,90,10,1,C
224G,224G,15,2925,3000,75,90,10,1,C
224G,224G,28,0,11,11,90,10,1,C
224G,224G,28,25,60,35,90,10,1,C
224G,224G,28,125,148,23,90,10,1,C
224G,224G,28,153,167,14,90,10,1,C
224G,224G,28,172,203,31,90,10,1,C
224G,224G,28,258,275,17,90,10,1,C
224G,224G,28,282,312,30,90,10,1,C
224G,224G,28,469,483,14,90,10,1,C
224G,224G,28,568,585,17,90,10,1,C
224G,224G,28,600,666,66,90,10,1,C
224G,224G,28,681,753,72,90,10,1,C
224G,224G,28,772,832,60,90,10,1,C
224G,224G,28,889,1078,189,90,10,1,C
224G,224G,28,1098,1167,69,90,10,1,C
224G,224G,28,1172,1192,20,90,10,1,C
224G,224G,28,1197,1236,39,90,10,1,C
224G,224G,28,1242,1257,15,90,10,1,C
224G,224G,28,1270,1313,43,90,10,1,C
224G,224G,28,1340,1368,28,90,10,1,C
224G,224G,28,1388,1420,32,90,10,1,C
224G,224G,28,1477,1494,17,90,10,1,C
224G,224G,28,1505,1520,15,90,10,1,C
224G,224G,28,1540,1565,25,90,10,1,C
224G,224G,28,1596,1629,33,90,10,1,C
224G,224G,28,1789,1810,21,90,10,1,C
224G,224G,28,1868,1885,17,90,10,1,C
224G,224G,28,2074,2106,32,90,10,1,C
224G,224G,28,2197,2211,14,90,10,1,C
224G,224G,28,2216,2237,21,90,10,1,C
224G,224G,28,2301,2343,42,90,10,1,C
224G,224G,28,2418,2442,24,90,10,1,C
224G,224G,28,2541,2555,14,90,10,1,C
224G,224G,28,2629,2706,77,90,10,1,C
224G,224G,28,2739,2761,22,90,10,1,C
224G,224G,28,2790,2802,12,90,10,1,C
224G,224G,28,2950,2964,14,90,10,1,C
225A,225A,2,0,26,26,90,10,1,C
225A,225A,2,38,54,16,90,10,1,C
225A,225A,2,95,105,10,90,10,1,C
225A,225A,2,126,147,21,90,10,1,C
225A,225A,2,253,261,8,90,10,1,C
225A,225A,2,374,411,37,90,10,1,C
225A,225A,2,515,529,14,90,10,1,C
225A,225A,2,560,610,50,90,10,1,C
225A,225A,2,638,700,62,90,10,1,C
225A,225A,2,715,731,16,90,10,1,C
225A,225A,2,739,789,50,90,10,1,C
225A,225A,2,809,848,39,90,10,1,C
225A,225A,2,993,1006,13,90,10,1,C
225A,225A,2,1027,1048,21,90,10,1,C
225A,225A,2,1105,1131,26,90,10,1,C
225A,225A,2,1187,1246,59,90,10,1,C
225A,225A,2,1255,1305,50,90,10,1,C
225A,225A,2,1310,1336,26,90,10,1,C
225A,225A,2,1344,1408,64,90,10,1,C
225A,225A,2,1478,1537,59,90,10,1,C
225A,225A,2,1548,1594,46,90,10,1,C
225A,225A,2,1603,1653,50,90,10,1,C
225A,225A,2,1721,1780,59,90,10,1,C
225A,225A,2,1795,1879,84,90,10,1,C
225A,225A,2,1903,1937,34,90,10,1,C
225A,225A,2,1976,2008,32,90,10,1,C
225A,225A,2,2160,2183,23,90,10,1,C
225A,225A,2,2227,2241,14,90,10,1,C
225A,225A,2,2265,2301,36,90,10,1,C
225A,225A,2,2452,2495,43,90,10,1,C
225A,225A,2,2512,2535,23,90,10,1,C
225A,225A,2,2629,2647,18,90,10,1,C
225A,225A,2,2660,2679,19,90,10,1,C
225A,225A,2,2709,2739,30,90,10,1,C
225A,225A,2,2762,2796,34,90,10,1,C
225A,225A,2,2870,2888,18,90,10,1,C
225A,225A,15,0,40,40,90,10,1,C
225A,225A,15,100,114,14,90,10,1,C
225A,225A,15,123,139,16,90,10,1,C
225A,225A,15,177,191,14,90,10,1,C
225A,225A,15,208,226,18,90,10,1,C
225A,225A,15,399,415,16,90,10,1,C
225A,225A,15,471,493,22,90,10,1,C
225A,225A,15,506,518,12,90,10,1,C
225A,225A,15,594,610,16,90,10,1,C
225A,225A,15,627,671,44,90,10,1,C
225A,225A,15,688,704,16,90,10,1,C
225A,225A,15,759,786,27,90,10,1,C
225A,225A,15,794,820,26,90,10,1,C
225A,225A,15,827,841,14,90,10,1,C
225A,225A,15,849,861,12,90,10,1,C
225A,225A,15,867,906,39,90,10,1,C
225A,225A,15,911,992,81,90,10,1,C
225A,225A,15,1003,1017,14,90,10,1,C
225A,225A,15,1035,1050,15,90,10,1,C
225A,225A,15,1055,1071,16,90,10,1,C
225A,225A,15,1081,1109,28,90,10,1,C
225A,225A,15,1154,1173,19,90,10,1,C
225A,225A,15,1183,1245,62,90,10,1,C
225A,225A,15,1302,1323,21,90,10,1,C
225A,225A,15,1554,1585,31,90,10,1,C
225A,225A,15,1598,1628,30,90,10,1,C
225A,225A,15,1632,1656,24,90,10,1,C
225A,225A,15,1707,1749,42,90,10,1,C
225A,225A,15,1786,1808,22,90,10,1,C
225A,225A,15,1820,1855,35,90,10,1,C
225A,225A,15,1883,1903,20,90,10,1,C
225A,225A,15,1931,1948,17,90,10,1,C
225A,225A,15,1987,2034,47,90,10,1,C
225A,225A,15,2060,2080,20,90,10,1,C
225A,225A,15,2100,2136,36,90,10,1,C
225A,225A,15,2195,2249,54,90,10,1,C
225A,225A,15,2255,2275,20,90,10,1,C
225A,225A,15,2375,2392,17,90,10,1,C
225A,225A,15,2397,2412,15,90,10,1,C
225A,225A,15,2453,2506,53,90,10,1,C
225A,225A,15,2511,2529,18,90,10,1,C
225A,225A,15,2534,2551,17,90,10,1,C
225A,225A,15,2556,2566,10,90,10,1,C
225A,225A,15,2585,2600,15,90,10,1,C
225A,225A,15,2641,2659,18,90,10,1,C
225A,225A,15,2872,2895,23,90,10,1,C
225A,225A,15,2905,2918,13,90,10,1,C
225A,225A,15,2923,2957,34,90,10,1,C
225A,225A,15,2963,2980,17,90,10,1,C
225A,225A,15,2987,3000,13,90,10,1,C
225A,225A,28,24,41,17,90,10,1,C
225A,225A,28,65,75,10,90,10,1,C
225A,225A,28,147,158,11,90,10,1,C
225A,225A,28,181,193,12,90,10,1,C
225A,225A,28,220,246,26,90,10,1,C
225A,225A,28,441,544,103,90,10,1,C
225A,225A,28,629,640,11,90,10,1,C
225A,225A,28,648,664,16,90,10,1,C
225A,225A,28,669,687,18,90,10,1,C
225A,225A,28,733,744,11,90,10,1,C
225A,225A,28,789,848,59,90,10,1,C
225A,225A,28,905,920,15,90,10,1,C
225A,225A,28,1022,1055,33,90,10,1,C
225A,225A,28,1119,1144,25,90,10,1,C
225A,225A,28,1173,1197,24,90,10,1,C
225A,225A,28,1219,1238,19,90,10,1,C
225A,225A,28,1265,1287,22,90,10,1,C
225A,225A,28,1322,1387,65,90,10,1,C
225A,225A,28,1412,1440,28,90,10,1,C
225A,225A,28,1458,1480,22,90,10,1,C
225A,225A,28,1597,1628,31,90,10,1,C
225A,225A,28,1650,1674,24,90,10,1,C
225A,225A,28,1751,1832,81,90,10,1,C
225A,225A,28,1842,1873,31,90,10,1,C
225A,225A,28,1883,1899,16,90,10,1,C
225A,225A,28,1916,1955,39,90,10,1,C
225A,225A,28,1966,1976,10,90,10,1,C
225A,225A,28,1981,2004,23,90,10,1,C
225A,225A,28,2054,2085,31,90,10,1,C
225A,225A,28,2090,2134,44,90,10,1,C
225A,225A,28,2150,2185,35,90,10,1,C
225A,225A,28,2200,2214,14,90,10,1,C
225A,225A,28,2229,2245,16,90,10,1,C
225A,225A,28,2259,2269,10,90,10,1,C
225A,225A,28,2285,2300,15,90,10,1,C
225A,225A,28,2310,2320,10,90,10,1,C
225A,225A,28,2359,2381,22,90,10,1,C
225A,225A,28,2405,2417,12,90,10,1,C
225A,225A,28,2450,2505,55,90,10,1,C
225A,225A,28,2511,2529,18,90,10,1,C
225A,225A,28,2562,2575,13,90,10,1,C
225A,225A,28,2648,2661,13,90,10,1,C
225A,225A,28,2711,2751,40,90,10,1,C
225A,225A,28,2787,2804,17,90,10,1,C
225A,225A,28,2809,2826,17,90,10,1,C
225A,225A,28,2832,2859,27,90,10,1,C
225A,225A,28,2932,2959,27,90,10,1,C
225G,225G,2,0,58,58,90,10,1,C
225G,225G,2,102,165,63,90,10,1,C
225G,225G,2,196,249,53,90,10,1,C
225G,225G,2,376,415,39,90,10,1,C
225G,225G,2,496,514,18,90,10,1,C
225G,225G,2,520,537,17,90,10,1,C
225G,225G,2,577,605,28,90,10,1,C
225G,225G,2,619,659,40,90,10,1,C
225G,225G,2,1017,1037,20,90,10,1,C
225G,225G,2,1362,1378,16,90,10,1,C
225G,225G,2,1519,1536,17,90,10,1,C
225G,225G,2,1681,1969,288,90,10,1,C
225G,225G,15,0,10,10,90,10,1,C
225G,225G,15,15,34,19,90,10,1,C
225G,225G,15,220,274,54,90,10,1,C
225G,225G,15,992,1078,86,90,10,1,C
225G,225G,15,1095,1108,13,90,10,1,C
225G,225G,15,1200,1233,33,90,10,1,C
225G,225G,15,1241,1260,19,90,10,1,C
225G,225G,15,1279,1295,16,90,10,1,C
225G,225G,15,1340,1395,55,90,10,1,C
225G,225G,15,1401,1418,17,90,10,1,C
225G,225G,15,1449,1479,30,90,10,1,C
225G,225G,15,1490,1503,13,90,10,1,C
225G,225G,15,1523,1549,26,90,10,1,C
225G,225G,15,1560,1592,32,90,10,1,C
225G,225G,15,1717,1735,18,90,10,1,C
225G,225G,15,1743,1789,46,90,10,1,C
225G,225G,15,1851,1865,14,90,10,1,C
225G,225G,15,1872,1889,17,90,10,1,C
225G,225G,15,1967,1981,14,90,10,1,C
225G,225G,15,2000,2040,40,90,10,1,C
225G,225G,15,2051,2092,41,90,10,1,C
225G,225G,15,2113,2177,64,90,10,1,C
225G,225G,15,2184,2265,81,90,10,1,C
225G,225G,15,2301,2367,66,90,10,1,C
225G,225G,15,2380,2429,49,90,10,1,C
225G,225G,15,2547,2560,13,90,10,1,C
225G,225G,15,2666,2688,22,90,10,1,C
225G,225G,15,2787,2837,50,90,10,1,C
225G,225G,15,2948,2971,23,90,10,1,C
225G,225G,15,2980,3000,20,90,10,1,C
225G,225G,28,360,405,45,90,10,1,C
225G,225G,28,582,595,13,90,10,1,C
225G,225G,28,664,680,16,90,10,1,C
225G,225G,28,693,716,23,90,10,1,C
225G,225G,28,735,785,50,90,10,1,C
225G,225G,28,802,876,74,90,10,1,C
225G,225G,28,908,943,35,90,10,1,C
225G,225G,28,948,974,26,90,10,1,C
225G,225G,28,985,1039,54,90,10,1,C
225G,225G,28,1071,1101,30,90,10,1,C
225G,225G,28,1117,1185,68,90,10,1,C
225G,225G,28,1212,1228,16,90,10,1,C
225G,225G,28,1380,1392,12,90,10,1,C
225G,225G,28,1879,1914,35,90,10,1,C
225G,225G,28,2082,2097,15,90,10,1,C
225G,225G,28,2153,2172,19,90,10,1,C
225G,225G,28,2180,2211,31,90,10,1,C
225G,225G,28,2678,2771,93,90,10,1,C
226A,226A,2,426,445,19,90,10,1,C
226A,226A,2,679,694,15,90,10,1,C
226A,226A,2,734,767,33,90,10,1,C
226A,226A,2,896,912,16,90,10,1,C
226A,226A,2,1318,1345,27,90,10,1,C
226A,226A,2,1363,1399,36,90,10,1,C
226A,226A,2,1439,1455,16,90,10,1,C
226A,226A,2,1512,1524,12,90,10,1,C
226A,226A,2,1623,1717,94,90,10,1,C
226A,226A,2,1854,1873,19,90,10,1,C
226A,226A,2,2985,2997,12,90,10,1,C
226A,226A,15,106,134,28,90,10,1,C
226A,226A,15,161,171,10,90,10,1,C
226A,226A,15,188,206,18,90,10,1,C
226A,226A,15,385,410,25,90,10,1,C
226A,226A,15,636,664,28,90,10,1,C
226A,226A,15,721,743,22,90,10,1,C
226A,226A,15,783,802,19,90,10,1,C
226A,226A,15,1100,1140,40,90,10,1,C
226A,226A,15,1268,1296,28,90,10,1,C
226A,226A,15,1339,1364,25,90,10,1,C
226A,226A,15,1381,1404,23,90,10,1,C
226A,226A,15,1420,1437,17,90,10,1,C
226A,226A,15,1540,1553,13,90,10,1,C
226A,226A,15,1733,1750,17,90,10,1,C
226A,226A,15,1871,1894,23,90,10,1,C
226A,226A,15,2213,2226,13,90,10,1,C
226A,226A,15,2632,2648,16,90,10,1,C
226A,226A,15,2730,2751,21,90,10,1,C
226A,226A,15,2850,2865,15,90,10,1,C
226A,226A,15,2983,3000,17,90,10,1,C
226A,226A,28,71,114,43,90,10,1,C
226A,226A,28,208,221,13,90,10,1,C
226A,226A,28,1241,1255,14,90,10,1,C
226A,226A,28,1299,1341,42,90,10,1,C
226A,226A,28,1500,1519,19,90,10,1,C
226A,226A,28,1609,1626,17,90,10,1,C
226A,226A,28,1837,1863,26,90,10,1,C
226A,226A,28,2042,2061,19,90,10,1,C
226A,226A,28,2103,2126,23,90,10,1,C
226A,226A,28,2480,2502,22,90,10,1,C
226A,226A,28,2510,2538,28,90,10,1,C
226A,226A,28,2667,2683,16,90,10,1,C
226A,226A,28,2872,2899,27,90,10,1,C
226G,226G,2,22,32,10,90,10,1,C
226G,226G,2,58,98,40,90,10,1,C
226G,226G,2,107,136,29,90,10,1,C
226G,226G,2,139,184,45,90,10,1,C
226G,226G,2,205,279,74,90,10,1,C
226G,226G,2,356,371,15,90,10,1,C
226G,226G,2,374,396,22,90,10,1,C
226G,226G,2,402,442,40,90,10,1,C
226G,226G,2,464,479,15,90,10,1,C
226G,226G,2,482,510,28,90,10,1,C
226G,226G,2,729,740,11,90,10,1,C
226G,226G,2,768,770,2,90,10,1,C
226G,226G,2,745,818,73,90,10,1,C
226G,226G,2,918,932,14,90,10,1,C
226G,226G,2,938,957,19,90,10,1,C
226G,226G,2,1065,1075,10,90,10,1,C
226G,226G,2,1078,1089,11,90,10,1,C
226G,226G,2,1199,1221,22,90,10,1,C
226G,226G,2,1234,1247,13,90,10,1,C
226G,226G,2,1273,1304,31,90,10,1,C
226G,226G,2,1313,1355,42,90,10,1,C
226G,226G,2,1413,1434,21,90,10,1,C
226G,226G,2,1451,1464,13,90,10,1,C
226G,226G,2,1524,1549,25,90,10,1,C
226G,226G,2,1746,1817,71,90,10,1,C
226G,226G,2,1834,1852,18,90,10,1,C
226G,226G,2,1859,1885,26,90,10,1,C
226G,226G,2,1889,1914,25,90,10,1,C
226G,226G,2,1936,1957,21,90,10,1,C
226G,226G,2,1967,1989,22,90,10,1,C
226G,226G,2,1992,2007,15,90,10,1,C
226G,226G,2,2004,2030,26,90,10,1,C
226G,226G,2,2034,2046,12,90,10,1,C
226G,226G,2,2174,2192,18,90,10,1,C
226G,226G,2,2203,2279,76,90,10,1,C
226G,226G,2,2282,2308,26,90,10,1,C
226G,226G,2,2312,2370,58,90,10,1,C
226G,226G,2,2390,2404,14,90,10,1,C
226G,226G,2,2424,2501,77,90,10,1,C
226G,226G,2,2515,2530,15,90,10,1,C
226G,226G,2,2532,2547,15,90,10,1,C
226G,226G,2,2562,2595,33,90,10,1,C
226G,226G,2,2628,2637,9,90,10,1,C
226G,226G,2,2658,2684,26,90,10,1,C
226G,226G,2,2645,2720,75,90,10,1,C
226G,226G,2,2746,2807,61,90,10,1,C
226G,226G,2,2843,2850,7,90,10,1,C
226G,226G,2,2854,2904,50,90,10,1,C
226G,226G,2,2907,2918,11,90,10,1,C
226G,226G,2,2922,2937,15,90,10,1,C
226G,226G,2,2944,2954,10,90,10,1,C
226G,226G,2,2771,3000,229,90,10,1,C
226G,226G,15,6,21,15,90,10,1,C
226G,226G,15,34,66,32,90,10,1,C
226G,226G,15,70,80,10,90,10,1,C
226G,226G,15,107,122,15,90,10,1,C
226G,226G,15,126,143,17,90,10,1,C
226G,226G,15,144,168,24,90,10,1,C
226G,226G,15,195,228,33,90,10,1,C
226G,226G,15,228,242,14,90,10,1,C
226G,226G,15,246,260,14,90,10,1,C
226G,226G,15,275,291,16,90,10,1,C
226G,226G,15,296,338,42,90,10,1,C
226G,226G,15,348,352,4,90,10,1,C
226G,226G,15,414,428,14,90,10,1,C
226G,226G,15,445,477,32,90,10,1,C
226G,226G,15,499,510,11,90,10,1,C
226G,226G,15,572,613,41,90,10,1,C
226G,226G,15,619,631,12,90,10,1,C
226G,226G,15,670,682,12,90,10,1,C
226G,226G,15,708,727,19,90,10,1,C
226G,226G,15,729,772,43,90,10,1,C
226G,226G,15,778,795,17,90,10,1,C
226G,226G,15,816,852,36,90,10,1,C
226G,226G,15,880,919,39,90,10,1,C
226G,226G,15,990,1007,17,90,10,1,C
226G,226G,15,1058,1072,14,90,10,1,C
226G,226G,15,1079,1090,11,90,10,1,C
226G,226G,15,1091,1115,24,90,10,1,C
226G,226G,15,1122,1136,14,90,10,1,C
226G,226G,15,1200,1220,20,90,10,1,C
226G,226G,15,1231,1241,10,90,10,1,C
226G,226G,15,1341,1358,17,90,10,1,C
226G,226G,15,1362,1375,13,90,10,1,C
226G,226G,15,1468,1499,31,90,10,1,C
226G,226G,15,1531,1542,11,90,10,1,C
226G,226G,15,1550,1560,10,90,10,1,C
226G,226G,15,1571,1612,41,90,10,1,C
226G,226G,15,1616,1630,14,90,10,1,C
226G,226G,15,1642,1674,32,90,10,1,C
226G,226G,15,1684,1716,32,90,10,1,C
226G,226G,15,1741,1755,14,90,10,1,C
226G,226G,15,1758,1800,42,90,10,1,C
226G,226G,15,1807,1825,18,90,10,1,C
226G,226G,15,1831,1841,10,90,10,1,C
226G,226G,15,1845,1860,15,90,10,1,C
226G,226G,15,1868,1884,16,90,10,1,C
226G,226G,15,1846,1921,75,90,10,1,C
226G,226G,15,1943,1974,31,90,10,1,C
226G,226G,15,2282,2312,30,90,10,1,C
226G,226G,15,2353,2378,25,90,10,1,C
226G,226G,15,2390,2418,28,90,10,1,C
226G,226G,15,2460,2475,15,90,10,1,C
226G,226G,15,2493,2505,12,90,10,1,C
226G,226G,15,2539,2556,17,90,10,1,C
226G,226G,15,2616,2645,29,90,10,1,C
226G,226G,15,2670,2703,33,90,10,1,C
226G,226G,28,26,42,16,90,10,1,C
226G,226G,28,55,66,11,90,10,1,C
226G,226G,28,89,156,67,90,10,1,C
226G,226G,28,60,72,12,90,10,1,C
226G,226G,28,181,247,66,90,10,1,C
226G,226G,28,266,278,12,90,10,1,C
226G,226G,28,292,355,63,90,10,1,C
226G,226G,28,361,402,41,90,10,1,C
226G,226G,28,415,436,21,90,10,1,C
226G,226G,28,466,536,70,90,10,1,C
226G,226G,28,542,612,70,90,10,1,C
226G,226G,28,623,663,40,90,10,1,C
226G,226G,28,675,693,18,90,10,1,C
226G,226G,28,817,879,62,90,10,1,C
226G,226G,28,890,905,15,90,10,1,C
226G,226G,28,910,940,30,90,10,1,C
226G,226G,28,950,990,40,90,10,1,C
226G,226G,28,997,1014,17,90,10,1,C
226G,226G,28,1020,1037,17,90,10,1,C
226G,226G,28,1063,1112,49,90,10,1,C
226G,226G,28,1267,1325,58,90,10,1,C
226G,226G,28,1331,1369,38,90,10,1,C
226G,226G,28,1381,1404,23,90,10,1,C
226G,226G,28,1410,1445,35,90,10,1,C
226G,226G,28,1468,1479,11,90,10,1,C
226G,226G,28,1483,1502,19,90,10,1,C
226G,226G,28,1510,1525,15,90,10,1,C
226G,226G,28,1530,1556,26,90,10,1,C
226G,226G,28,1566,1610,44,90,10,1,C
226G,226G,28,1615,1634,19,90,10,1,C
226G,226G,28,1647,1660,13,90,10,1,C
226G,226G,28,1689,1703,14,90,10,1,C
226G,226G,28,1709,1760,51,90,10,1,C
226G,226G,28,1783,1830,47,90,10,1,C
226G,226G,28,1839,1847,8,90,10,1,C
226G,226G,28,1858,1869,11,90,10,1,C
226G,226G,28,1880,1890,10,90,10,1,C
226G,226G,28,1910,2000,90,90,10,1,C
226G,226G,28,2020,2063,43,90,10,1,C
226G,226G,28,2074,2118,44,90,10,1,C
226G,226G,28,2137,2157,20,90,10,1,C
226G,226G,28,2193,2213,20,90,10,1,C
226G,226G,28,2224,2238,14,90,10,1,C
226G,226G,28,2247,2302,55,90,10,1,C
226G,226G,28,2470,2523,53,90,10,1,C
226G,226G,28,2535,2573,38,90,10,1,C
226G,226G,28,2620,2663,43,90,10,1,C
226G,226G,28,2684,2702,18,90,10,1,C
226G,226G,28,2717,2807,90,90,10,1,C
226G,226G,28,2813,2859,46,90,10,1,C
226G,226G,28,2870,2923,53,90,10,1,C
226G,226G,28,2965,2979,14,90,10,1,C
226G,226G,28,2985,3000,15,90,10,1,C
227A,227A,2,65,83,18,90,10,1,C
227A,227A,2,102,116,14,90,10,1,C
227A,227A,2,122,174,52,90,10,1,C
227A,227A,2,199,211,12,90,10,1,C
227A,227A,2,385,427,42,90,10,1,C
227A,227A,2,497,514,17,90,10,1,C
227A,227A,2,592,607,15,90,10,1,C
227A,227A,2,643,656,13,90,10,1,C
227A,227A,2,680,695,15,90,10,1,C
227A,227A,2,880,894,14,90,10,1,C
227A,227A,2,910,925,15,90,10,1,C
227A,227A,2,940,952,12,90,10,1,C
227A,227A,2,1010,1033,23,90,10,1,C
227A,227A,2,1070,1100,30,90,10,1,C
227A,227A,2,1118,1142,24,90,10,1,C
227A,227A,2,1226,1260,34,90,10,1,C
227A,227A,2,1331,1359,28,90,10,1,C
227A,227A,2,1467,1490,23,90,10,1,C
227A,227A,2,1703,1723,20,90,10,1,C
227A,227A,2,1900,1914,14,90,10,1,C
227A,227A,2,1922,1940,18,90,10,1,C
227A,227A,2,2330,2347,17,90,10,1,C
227A,227A,2,2360,2386,26,90,10,1,C
227A,227A,2,2419,2444,25,90,10,1,C
227A,227A,2,2610,2629,19,90,10,1,C
227A,227A,2,2637,2650,13,90,10,1,C
227A,227A,2,2655,2668,13,90,10,1,C
227A,227A,2,2715,2736,21,90,10,1,C
227A,227A,2,2765,2784,19,90,10,1,C
227A,227A,2,2903,2913,10,90,10,1,C
227A,227A,15,123,175,52,90,10,1,C
227A,227A,15,213,259,46,90,10,1,C
227A,227A,15,323,348,25,90,10,1,C
227A,227A,15,379,395,16,90,10,1,C
227A,227A,15,411,455,44,90,10,1,C
227A,227A,15,515,529,14,90,10,1,C
227A,227A,15,590,600,10,90,10,1,C
227A,227A,15,660,670,10,90,10,1,C
227A,227A,15,675,687,12,90,10,1,C
227A,227A,15,696,710,14,90,10,1,C
227A,227A,15,733,749,16,90,10,1,C
227A,227A,15,813,868,55,90,10,1,C
227A,227A,15,880,890,10,90,10,1,C
227A,227A,15,924,938,14,90,10,1,C
227A,227A,15,990,1010,20,90,10,1,C
227A,227A,15,1015,1040,25,90,10,1,C
227A,227A,15,1178,1200,22,90,10,1,C
227A,227A,15,1302,1333,31,90,10,1,C
227A,227A,15,1360,1383,23,90,10,1,C
227A,227A,15,1389,1419,30,90,10,1,C
227A,227A,15,1483,1500,17,90,10,1,C
227A,227A,15,1774,1788,14,90,10,1,C
227A,227A,15,1990,2025,35,90,10,1,C
227A,227A,15,2079,2127,48,90,10,1,C
227A,227A,15,2146,2165,19,90,10,1,C
227A,227A,15,2192,2205,13,90,10,1,C
227A,227A,15,2210,2223,13,90,10,1,C
227A,227A,15,2300,2314,14,90,10,1,C
227A,227A,15,2325,2350,25,90,10,1,C
227A,227A,15,2379,2407,28,90,10,1,C
227A,227A,15,2438,2470,32,90,10,1,C
227A,227A,15,2500,2517,17,90,10,1,C
227A,227A,15,2565,2580,15,90,10,1,C
227A,227A,15,2585,2595,10,90,10,1,C
227A,227A,15,2660,2673,13,90,10,1,C
227A,227A,15,2705,2715,10,90,10,1,C
227A,227A,15,2838,2850,12,90,10,1,C
227A,227A,15,2968,2982,14,90,10,1,C
227A,227A,28,26,44,18,90,10,1,C
227A,227A,28,59,75,16,90,10,1,C
227A,227A,28,114,127,13,90,10,1,C
227A,227A,28,182,196,14,90,10,1,C
227A,227A,28,233,247,14,90,10,1,C
227A,227A,28,470,487,17,90,10,1,C
227A,227A,28,492,522,30,90,10,1,C
227A,227A,28,547,569,22,90,10,1,C
227A,227A,28,648,665,17,90,10,1,C
227A,227A,28,750,760,10,90,10,1,C
227A,227A,28,779,795,16,90,10,1,C
227A,227A,28,953,967,14,90,10,1,C
227A,227A,28,1108,1123,15,90,10,1,C
227A,227A,28,1220,1241,21,90,10,1,C
227A,227A,28,1282,1297,15,90,10,1,C
227A,227A,28,1380,1399,19,90,10,1,C
227A,227A,28,1478,1488,10,90,10,1,C
227A,227A,28,1510,1523,13,90,10,1,C
227A,227A,28,1643,1656,13,90,10,1,C
227A,227A,28,1755,1767,12,90,10,1,C
227A,227A,28,1820,1842,22,90,10,1,C
227A,227A,28,1956,1986,30,90,10,1,C
227A,227A,28,2040,2050,10,90,10,1,C
227A,227A,28,2057,2072,15,90,10,1,C
227A,227A,28,2154,2182,28,90,10,1,C
227A,227A,28,2286,2303,17,90,10,1,C
227A,227A,28,2312,2324,12,90,10,1,C
227A,227A,28,2347,2358,11,90,10,1,C
227A,227A,28,2398,2413,15,90,10,1,C
227A,227A,28,2571,2588,17,90,10,1,C
227A,227A,28,2594,2615,21,90,10,1,C
227A,227A,28,2670,2689,19,90,10,1,C
227A,227A,28,2700,2716,16,90,10,1,C
227A,227A,28,2721,2752,31,90,10,1,C
227A,227A,28,2757,2768,11,90,10,1,C
227A,227A,28,2786,2800,14,90,10,1,C
227A,227A,28,2835,2868,33,90,10,1,C
227A,227A,28,2901,2917,16,90,10,1,C
227A,227A,28,2924,2944,20,90,10,1,C
227G,227G,2,24,42,18,90,10,1,C
227G,227G,2,50,62,12,90,10,1,C
227G,227G,2,81,118,37,90,10,1,C
227G,227G,2,135,168,33,90,10,1,C
227G,227G,2,223,268,45,90,10,1,C
227G,227G,2,275,292,17,90,10,1,C
227G,227G,2,329,350,21,90,10,1,C
227G,227G,2,352,367,15,90,10,1,C
227G,227G,2,389,405,16,90,10,1,C
227G,227G,2,468,473,5,90,10,1,C
227G,227G,2,524,557,33,90,10,1,C
227G,227G,2,621,635,14,90,10,1,C
227G,227G,2,659,722,63,90,10,1,C
227G,227G,2,736,745,9,90,10,1,C
227G,227G,2,762,773,11,90,10,1,C
227G,227G,2,782,808,26,90,10,1,C
227G,227G,2,832,856,24,90,10,1,C
227G,227G,2,862,882,20,90,10,1,C
227G,227G,2,901,911,10,90,10,1,C
227G,227G,2,941,969,28,90,10,1,C
227G,227G,2,1009,1024,15,90,10,1,C
227G,227G,2,1028,1034,6,90,10,1,C
227G,227G,2,1161,1175,14,90,10,1,C
227G,227G,2,1274,1291,17,90,10,1,C
227G,227G,2,1353,1367,14,90,10,1,C
227G,227G,2,1408,1420,12,90,10,1,C
227G,227G,2,1460,1491,31,90,10,1,C
227G,227G,2,1523,1555,32,90,10,1,C
227G,227G,2,1582,1595,13,90,10,1,C
227G,227G,2,1628,1672,44,90,10,1,C
227G,227G,2,1679,1692,13,90,10,1,C
227G,227G,2,1703,1732,29,90,10,1,C
227G,227G,2,1774,1784,10,90,10,1,C
227G,227G,2,1790,1812,22,90,10,1,C
227G,227G,2,1863,1882,19,90,10,1,C
227G,227G,2,1900,1914,14,90,10,1,C
227G,227G,2,2016,2041,25,90,10,1,C
227G,227G,2,2076,2106,30,90,10,1,C
227G,227G,2,2104,2133,29,90,10,1,C
227G,227G,2,2142,2159,17,90,10,1,C
227G,227G,2,2182,2192,10,90,10,1,C
227G,227G,2,2250,2268,18,90,10,1,C
227G,227G,2,2275,2302,27,90,10,1,C
227G,227G,2,2324,2346,22,90,10,1,C
227G,227G,2,2350,2365,15,90,10,1,C
227G,227G,2,2370,2386,16,90,10,1,C
227G,227G,2,2419,2443,24,90,10,1,C
227G,227G,2,2451,2471,20,90,10,1,C
227G,227G,2,2481,2492,11,90,10,1,C
227G,227G,2,2505,2524,19,90,10,1,C
227G,227G,2,2530,2557,27,90,10,1,C
227G,227G,2,2568,2601,33,90,10,1,C
227G,227G,2,2823,2855,32,90,10,1,C
227G,227G,2,2868,2880,12,90,10,1,C
227G,227G,2,2890,2921,31,90,10,1,C
227G,227G,2,2948,2962,14,90,10,1,C
227G,227G,15,16,33,17,90,10,1,C
227G,227G,15,92,113,21,90,10,1,C
227G,227G,15,135,159,24,90,10,1,C
227G,227G,15,289,308,19,90,10,1,C
227G,227G,15,404,423,19,90,10,1,C
227G,227G,15,445,462,17,90,10,1,C
227G,227G,15,592,627,35,90,10,1,C
227G,227G,15,739,750,11,90,10,1,C
227G,227G,15,812,844,32,90,10,1,C
227G,227G,15,869,892,23,90,10,1,C
227G,227G,15,899,909,10,90,10,1,C
227G,227G,15,941,999,58,90,10,1,C
227G,227G,15,1022,1040,18,90,10,1,C
227G,227G,15,1267,1280,13,90,10,1,C
227G,227G,15,1371,1388,17,90,10,1,C
227G,227G,15,1393,1413,20,90,10,1,C
227G,227G,15,1457,1468,11,90,10,1,C
227G,227G,15,1579,1589,10,90,10,1,C
227G,227G,15,1629,1651,22,90,10,1,C
227G,227G,15,1656,1680,24,90,10,1,C
227G,227G,15,2355,2376,21,90,10,1,C
227G,227G,15,2594,2621,27,90,10,1,C
227G,227G,15,2769,2784,15,90,10,1,C
227G,227G,28,120,139,19,90,10,1,C
227G,227G,28,633,653,20,90,10,1,C
227G,227G,28,660,673,13,90,10,1,C
227G,227G,28,704,735,31,90,10,1,C
227G,227G,28,796,819,23,90,10,1,C
227G,227G,28,825,844,19,90,10,1,C
227G,227G,28,855,877,22,90,10,1,C
227G,227G,28,883,947,64,90,10,1,C
227G,227G,28,973,1015,42,90,10,1,C
227G,227G,28,1038,1064,26,90,10,1,C
227G,227G,28,1267,1280,13,90,10,1,C
227G,227G,28,1351,1364,13,90,10,1,C
227G,227G,28,1426,1448,22,90,10,1,C
227G,227G,28,1485,1508,23,90,10,1,C
227G,227G,28,1515,1531,16,90,10,1,C
227G,227G,28,1540,1562,22,90,10,1,C
227G,227G,28,1573,1594,21,90,10,1,C
227G,227G,28,1615,1629,14,90,10,1,C
227G,227G,28,1666,1685,19,90,10,1,C
227G,227G,28,1715,1732,17,90,10,1,C
227G,227G,28,1772,1790,18,90,10,1,C
227G,227G,28,1822,1833,11,90,10,1,C
227G,227G,28,1841,1882,41,90,10,1,C
227G,227G,28,1896,1914,18,90,10,1,C
227G,227G,28,1939,1960,21,90,10,1,C
227G,227G,28,1981,2004,23,90,10,1,C
227G,227G,28,2032,2067,35,90,10,1,C
227G,227G,28,2074,2092,18,90,10,1,C
227G,227G,28,2331,2350,19,90,10,1,C
227G,227G,28,2373,2385,12,90,10,1,C
227G,227G,28,2443,2460,17,90,10,1,C
227G,227G,28,2488,2510,22,90,10,1,C
227G,227G,28,2515,2538,23,90,10,1,C
227G,227G,28,2548,2565,17,90,10,1,C
227G,227G,28,2601,2615,14,90,10,1,C
227G,227G,28,2626,2634,8,90,10,1,C
227G,227G,28,2650,2664,14,90,10,1,C
227G,227G,28,2675,2682,7,90,10,1,C
227G,227G,28,2702,2724,22,90,10,1,C
227G,227G,28,2731,2763,32,90,10,1,C
227G,227G,28,2796,2851,55,90,10,1,C
227G,227G,28,2870,2883,13,90,10,1,C
227G,227G,28,2909,2989,80,90,10,1,C
228A,228A,2,71,91,20,90,10,1,C
228A,228A,2,162,191,29,90,10,1,C
228A,228A,2,389,408,19,90,10,1,C
228A,228A,2,691,715,24,90,10,1,C
228A,228A,2,1178,1199,21,90,10,1,C
228A,228A,2,1369,1382,13,90,10,1,C
228A,228A,2,1546,1556,10,90,10,1,C
228A,228A,2,2040,2054,14,90,10,1,C
228A,228A,2,2066,2079,13,90,10,1,C
228A,228A,2,2093,2131,38,90,10,1,C
228A,228A,2,2160,2190,30,90,10,1,C
228A,228A,2,2207,2218,11,90,10,1,C
228A,228A,2,2256,2279,23,90,10,1,C
228A,228A,2,2291,2319,28,90,10,1,C
228A,228A,2,2326,2345,19,90,10,1,C
228A,228A,2,2352,2375,23,90,10,1,C
228A,228A,2,2414,2432,18,90,10,1,C
228A,228A,2,2456,2469,13,90,10,1,C
228A,228A,2,2479,2519,40,90,10,1,C
228A,228A,2,2561,2576,15,90,10,1,C
228A,228A,2,2583,2632,49,90,10,1,C
228A,228A,2,2642,2654,12,90,10,1,C
228A,228A,2,2661,2676,15,90,10,1,C
228A,228A,2,2685,2734,49,90,10,1,C
228A,228A,2,2742,2756,14,90,10,1,C
228A,228A,2,2771,2792,21,90,10,1,C
228A,228A,2,2805,2819,14,90,10,1,C
228A,228A,2,2841,2861,20,90,10,1,C
228A,228A,2,2874,2901,27,90,10,1,C
228A,228A,2,2951,2982,31,90,10,1,C
228A,228A,15,47,60,13,90,10,1,C
228A,228A,15,136,154,18,90,10,1,C
228A,228A,15,229,240,11,90,10,1,C
228A,228A,15,251,280,29,90,10,1,C
228A,228A,15,326,342,16,90,10,1,C
228A,228A,15,449,470,21,90,10,1,C
228A,228A,15,480,490,10,90,10,1,C
228A,228A,15,516,528,12,90,10,1,C
228A,228A,15,538,549,11,90,10,1,C
228A,228A,15,594,634,40,90,10,1,C
228A,228A,15,652,666,14,90,10,1,C
228A,228A,15,684,700,16,90,10,1,C
228A,228A,15,720,735,15,90,10,1,C
228A,228A,15,739,761,22,90,10,1,C
228A,228A,15,829,860,31,90,10,1,C
228A,228A,15,870,882,12,90,10,1,C
228A,228A,15,894,912,18,90,10,1,C
228A,228A,15,920,930,10,90,10,1,C
228A,228A,15,948,1003,55,90,10,1,C
228A,228A,15,1048,1091,43,90,10,1,C
228A,228A,15,1103,1168,65,90,10,1,C
228A,228A,15,1167,1197,30,90,10,1,C
228A,228A,15,1231,1305,74,90,10,1,C
228A,228A,15,1326,1370,44,90,10,1,C
228A,228A,15,1382,1399,17,90,10,1,C
228A,228A,15,1434,1457,23,90,10,1,C
228A,228A,15,1462,1506,44,90,10,1,C
228A,228A,15,1530,1561,31,90,10,1,C
228A,228A,15,1585,1595,10,90,10,1,C
228A,228A,15,1638,1659,21,90,10,1,C
228A,228A,15,1687,1704,17,90,10,1,C
228A,228A,15,1727,1741,14,90,10,1,C
228A,228A,15,2200,2226,26,90,10,1,C
228A,228A,15,2291,2326,35,90,10,1,C
228A,228A,15,2400,2411,11,90,10,1,C
228A,228A,15,2893,2912,19,90,10,1,C
228A,228A,15,2924,2940,16,90,10,1,C
228A,228A,28,224,243,19,90,10,1,C
228A,228A,28,254,269,15,90,10,1,C
228A,228A,28,286,312,26,90,10,1,C
228A,228A,28,356,388,32,90,10,1,C
228A,228A,28,1085,1100,15,90,10,1,C
228A,228A,28,1245,1259,14,90,10,1,C
228A,228A,28,1336,1372,36,90,10,1,C
228A,228A,28,1525,1537,12,90,10,1,C
228A,228A,28,1654,1667,13,90,10,1,C
228A,228A,28,1788,1804,16,90,10,1,C
228A,228A,28,1849,1865,16,90,10,1,C
228A,228A,28,1885,1898,13,90,10,1,C
228A,228A,28,2640,2653,13,90,10,1,C
228A,228A,28,2775,2796,21,90,10,1,C
228A,228A,28,2875,2899,24,90,10,1,C
228A,228A,28,2968,2978,10,90,10,1,C
228G,228G,2,310,320,10,90,10,1,C
228G,228G,2,1929,1960,31,90,10,1,C
228G,228G,2,2038,2055,17,90,10,1,C
228G,228G,2,2157,2172,15,90,10,1,C
228G,228G,2,2212,2235,23,90,10,1,C
228G,228G,15,94,105,11,90,10,1,C
228G,228G,15,150,174,24,90,10,1,C
228G,228G,15,183,195,12,90,10,1,C
228G,228G,15,204,226,22,90,10,1,C
228G,228G,15,293,305,12,90,10,1,C
228G,228G,15,316,340,24,90,10,1,C
228G,228G,15,345,364,19,90,10,1,C
228G,228G,15,379,395,16,90,10,1,C
228G,228G,15,475,486,11,90,10,1,C
228G,228G,15,493,510,17,90,10,1,C
228G,228G,15,524,545,21,90,10,1,C
228G,228G,15,666,685,19,90,10,1,C
228G,228G,15,940,955,15,90,10,1,C
228G,228G,15,994,1028,34,90,10,1,C
228G,228G,15,1032,1085,53,90,10,1,C
228G,228G,15,1105,1119,14,90,10,1,C
228G,228G,15,1138,1195,57,90,10,1,C
228G,228G,15,1560,1585,25,90,10,1,C
228G,228G,15,1810,1853,43,90,10,1,C
228G,228G,15,1894,1936,42,90,10,1,C
228G,228G,15,1994,2010,16,90,10,1,C
228G,228G,15,2050,2070,20,90,10,1,C
228G,228G,28,1003,1017,14,90,10,1,C
228G,228G,28,1208,1220,12,90,10,1,C
228G,228G,28,1588,1599,11,90,10,1,C
228G,228G,28,1790,1804,14,90,10,1,C
228G,228G,28,2673,2684,11,90,10,1,C
228G,228G,28,2768,2798,30,90,10,1,C
228G,228G,28,2793,2811,18,90,10,1,C
228G,228G,28,2857,2872,15,90,10,1,C
228G,228G,28,2910,2956,46,90,10,1,C
229A,229A,2,131,142,11,90,10,1,C
229A,229A,2,147,157,10,90,10,1,C
229A,229A,2,822,838,16,90,10,1,C
229A,229A,2,961,986,25,90,10,1,C
229A,229A,2,989,1019,30,90,10,1,C
229A,229A,2,1024,1042,18,90,10,1,C
229A,229A,2,1051,1089,38,90,10,1,C
229A,229A,2,1177,1210,33,90,10,1,C
229A,229A,2,1309,1330,21,90,10,1,C
229A,229A,2,1338,1380,42,90,10,1,C
229A,229A,2,1406,1422,16,90,10,1,C
229A,229A,2,1441,1473,32,90,10,1,C
229A,229A,2,1496,1523,27,90,10,1,C
229A,229A,2,1573,1592,19,90,10,1,C
229A,229A,2,1650,1677,27,90,10,1,C
229A,229A,2,1688,1705,17,90,10,1,C
229A,229A,2,2113,2136,23,90,10,1,C
229A,229A,2,2312,2339,27,90,10,1,C
229A,229A,2,2382,2401,19,90,10,1,C
229A,229A,2,2719,2739,20,90,10,1,C
229A,229A,2,2802,2812,10,90,10,1,C
229A,229A,15,18,50,32,90,10,1,C
229A,229A,15,62,85,23,90,10,1,C
229A,229A,15,116,130,14,90,10,1,C
229A,229A,15,176,195,19,90,10,1,C
229A,229A,15,355,382,27,90,10,1,C
229A,229A,15,389,406,17,90,10,1,C
229A,229A,15,457,489,32,90,10,1,C
229A,229A,15,558,589,31,90,10,1,C
229A,229A,15,661,672,11,90,10,1,C
229A,229A,15,1023,1040,17,90,10,1,C
229A,229A,15,1105,1120,15,90,10,1,C
229A,229A,15,1449,1464,15,90,10,1,C
229A,229A,15,2163,2192,29,90,10,1,C
229A,229A,15,2258,2271,13,90,10,1,C
229A,229A,15,2339,2350,11,90,10,1,C
229A,229A,15,2708,2723,15,90,10,1,C
229A,229A,28,0,17,17,90,10,1,C
229A,229A,28,142,160,18,90,10,1,C
229A,229A,28,1115,1127,12,90,10,1,C
229A,229A,28,1811,1821,10,90,10,1,C
229A,229A,28,2233,2246,13,90,10,1,C
229A,229A,28,2621,2639,18,90,10,1,C
229A,229A,28,2653,2659,6,90,10,1,C
229G,229G,2,14,41,27,90,10,1,C
229G,229G,2,96,111,15,90,10,1,C
229G,229G,2,117,136,19,90,10,1,C
229G,229G,2,307,322,15,90,10,1,C
229G,229G,2,557,593,36,90,10,1,C
229G,229G,2,614,626,12,90,10,1,C
229G,229G,2,689,702,13,90,10,1,C
229G,229G,2,841,862,21,90,10,1,C
229G,229G,2,877,896,19,90,10,1,C
229G,229G,2,921,945,24,90,10,1,C
229G,229G,2,972,986,14,90,10,1,C
229G,229G,2,1411,1424,13,90,10,1,C
229G,229G,2,1484,1497,13,90,10,1,C
229G,229G,2,1512,1524,12,90,10,1,C
229G,229G,2,1547,1585,38,90,10,1,C
229G,229G,2,1757,1780,23,90,10,1,C
229G,229G,2,1962,1981,19,90,10,1,C
229G,229G,2,2130,2142,12,90,10,1,C
229G,229G,2,2214,2233,19,90,10,1,C
229G,229G,2,2262,2275,13,90,10,1,C
229G,229G,15,111,126,15,90,10,1,C
229G,229G,15,249,261,12,90,10,1,C
229G,229G,15,327,344,17,90,10,1,C
229G,229G,15,353,385,32,90,10,1,C
229G,229G,15,418,428,10,90,10,1,C
229G,229G,15,524,542,18,90,10,1,C
229G,229G,15,552,564,12,90,10,1,C
229G,229G,15,731,749,18,90,10,1,C
229G,229G,15,857,874,17,90,10,1,C
229G,229G,15,904,920,16,90,10,1,C
229G,229G,15,949,973,24,90,10,1,C
229G,229G,15,1074,1089,15,90,10,1,C
229G,229G,15,1109,1128,19,90,10,1,C
229G,229G,15,1191,1207,16,90,10,1,C
229G,229G,15,1232,1248,16,90,10,1,C
229G,229G,15,1304,1329,25,90,10,1,C
229G,229G,15,1332,1364,32,90,10,1,C
229G,229G,15,1375,1398,23,90,10,1,C
229G,229G,15,1472,1482,10,90,10,1,C
229G,229G,15,1515,1526,11,90,10,1,C
229G,229G,15,1556,1566,10,90,10,1,C
229G,229G,15,1591,1605,14,90,10,1,C
229G,229G,15,1634,1651,17,90,10,1,C
229G,229G,15,1689,1748,59,90,10,1,C
229G,229G,15,1781,1794,13,90,10,1,C
229G,229G,15,1849,1867,18,90,10,1,C
229G,229G,15,1904,1936,32,90,10,1,C
229G,229G,15,2129,2141,12,90,10,1,C
229G,229G,15,2161,2174,13,90,10,1,C
229G,229G,15,2237,2257,20,90,10,1,C
229G,229G,15,2321,2352,31,90,10,1,C
229G,229G,15,2367,2382,15,90,10,1,C
229G,229G,15,2396,2414,18,90,10,1,C
229G,229G,15,2446,2450,4,90,10,1,C
229G,229G,15,2520,2541,21,90,10,1,C
229G,229G,15,2544,2559,15,90,10,1,C
229G,229G,15,2641,2654,13,90,10,1,C
229G,229G,15,2714,2750,36,90,10,1,C
229G,229G,15,2756,2770,14,90,10,1,C
229G,229G,15,2782,2796,14,90,10,1,C
229G,229G,15,2818,2826,8,90,10,1,C
229G,229G,15,2849,2860,11,90,10,1,C
229G,229G,15,2912,2926,14,90,10,1,C
229G,229G,15,2947,2960,13,90,10,1,C
229G,229G,15,2967,2976,9,90,10,1,C
229G,229G,28,0,60,60,90,10,1,C
229G,229G,28,72,142,70,90,10,1,C
229G,229G,28,147,200,53,90,10,1,C
229G,229G,28,211,223,12,90,10,1,C
229G,229G,28,226,262,36,90,10,1,C
229G,229G,28,275,289,14,90,10,1,C
229G,229G,28,293,350,57,90,10,1,C
229G,229G,28,422,456,34,90,10,1,C
229G,229G,28,459,480,21,90,10,1,C
229G,229G,28,485,527,42,90,10,1,C
229G,229G,28,532,560,28,90,10,1,C
229G,229G,28,574,608,34,90,10,1,C
229G,229G,28,615,714,99,90,10,1,C
229G,229G,28,724,760,36,90,10,1,C
229G,229G,28,768,793,25,90,10,1,C
229G,229G,28,799,835,36,90,10,1,C
229G,229G,28,845,855,10,90,10,1,C
229G,229G,28,894,902,8,90,10,1,C
229G,229G,28,925,946,21,90,10,1,C
229G,229G,28,955,968,13,90,10,1,C
229G,229G,28,973,990,17,90,10,1,C
229G,229G,28,1013,1034,21,90,10,1,C
229G,229G,28,1050,1070,20,90,10,1,C
229G,229G,28,1082,1095,13,90,10,1,C
229G,229G,28,1210,1226,16,90,10,1,C
229G,229G,28,1250,1278,28,90,10,1,C
229G,229G,28,1295,1308,13,90,10,1,C
229G,229G,28,1316,1333,17,90,10,1,C
229G,229G,28,1357,1378,21,90,10,1,C
229G,229G,28,1385,1415,30,90,10,1,C
229G,229G,28,1440,1455,15,90,10,1,C
229G,229G,28,1462,1479,17,90,10,1,C
229G,229G,28,1483,1496,13,90,10,1,C
229G,229G,28,1507,1544,37,90,10,1,C
229G,229G,28,1567,1586,19,90,10,1,C
229G,229G,28,1594,1614,20,90,10,1,C
229G,229G,28,1640,1755,115,90,10,1,C
229G,229G,28,1800,1820,20,90,10,1,C
229G,229G,28,1894,1916,22,90,10,1,C
229G,229G,28,1935,1950,15,90,10,1,C
229G,229G,28,1957,1971,14,90,10,1,C
229G,229G,28,1979,2000,21,90,10,1,C
229G,229G,28,2009,2062,53,90,10,1,C
229G,229G,28,2071,2127,56,90,10,1,C
229G,229G,28,2162,2251,89,90,10,1,C
229G,229G,28,2266,2353,87,90,10,1,C
229G,229G,28,2365,2401,36,90,10,1,C
229G,229G,28,2406,2438,32,90,10,1,C
229G,229G,28,2444,2559,115,90,10,1,C
229G,229G,28,2569,2665,96,90,10,1,C
229G,229G,28,2674,2694,20,90,10,1,C
229G,229G,28,2722,2775,53,90,10,1,C
229G,229G,28,2786,2832,46,90,10,1,C
229G,229G,28,2846,2995,149,90,10,1,C
230A,230A,2,12,27,15,90,10,1,C
230A,230A,2,64,77,13,90,10,1,C
230A,230A,2,102,124,22,90,10,1,C
230A,230A,2,134,176,42,90,10,1,C
230A,230A,2,180,223,43,90,10,1,C
230A,230A,2,256,286,30,90,10,1,C
230A,230A,2,294,319,25,90,10,1,C
230A,230A,2,360,421,61,90,10,1,C
230A,230A,2,453,470,17,90,10,1,C
230A,230A,2,479,495,16,90,10,1,C
230A,230A,2,551,567,16,90,10,1,C
230A,230A,2,635,699,64,90,10,1,C
230A,230A,2,749,776,27,90,10,1,C
230A,230A,2,788,804,16,90,10,1,C
230A,230A,2,857,886,29,90,10,1,C
230A,230A,2,902,942,40,90,10,1,C
230A,230A,2,953,980,27,90,10,1,C
230A,230A,2,989,1024,35,90,10,1,C
230A,230A,2,1038,1092,54,90,10,1,C
230A,230A,2,1149,1167,18,90,10,1,C
230A,230A,2,1175,1207,32,90,10,1,C
230A,230A,2,1292,1310,18,90,10,1,C
230A,230A,2,1332,1350,18,90,10,1,C
230A,230A,2,1435,1486,51,90,10,1,C
230A,230A,2,1506,1545,39,90,10,1,C
230A,230A,2,1575,1602,27,90,10,1,C
230A,230A,2,1755,1774,19,90,10,1,C
230A,230A,2,1791,1839,48,90,10,1,C
230A,230A,2,1866,1889,23,90,10,1,C
230A,230A,2,1963,1977,14,90,10,1,C
230A,230A,2,1984,2002,18,90,10,1,C
230A,230A,2,2119,2135,16,90,10,1,C
230A,230A,2,2149,2163,14,90,10,1,C
230A,230A,2,2168,2194,26,90,10,1,C
230A,230A,2,2199,2222,23,90,10,1,C
230A,230A,2,2235,2261,26,90,10,1,C
230A,230A,2,2268,2279,11,90,10,1,C
230A,230A,2,2443,2471,28,90,10,1,C
230A,230A,2,2497,2532,35,90,10,1,C
230A,230A,2,2562,2575,13,90,10,1,C
230A,230A,2,2584,2666,82,90,10,1,C
230A,230A,2,2699,2728,29,90,10,1,C
230A,230A,2,2741,2789,48,90,10,1,C
230A,230A,2,2845,2878,33,90,10,1,C
230A,230A,2,2902,2936,34,90,10,1,C
230A,230A,2,2961,2980,19,90,10,1,C
230A,230A,15,0,29,29,90,10,1,C
230A,230A,15,66,102,36,90,10,1,C
230A,230A,15,112,126,14,90,10,1,C
230A,230A,15,168,206,38,90,10,1,C
230A,230A,15,214,280,66,90,10,1,C
230A,230A,15,282,295,13,90,10,1,C
230A,230A,15,312,330,18,90,10,1,C
230A,230A,15,335,412,77,90,10,1,C
230A,230A,15,441,475,34,90,10,1,C
230A,230A,15,504,534,30,90,10,1,C
230A,230A,15,547,617,70,90,10,1,C
230A,230A,15,650,684,34,90,10,1,C
230A,230A,15,690,706,16,90,10,1,C
230A,230A,15,716,728,12,90,10,1,C
230A,230A,15,740,760,20,90,10,1,C
230A,230A,15,772,802,30,90,10,1,C
230A,230A,15,819,868,49,90,10,1,C
230A,230A,15,874,906,32,90,10,1,C
230A,230A,15,910,937,27,90,10,1,C
230A,230A,15,947,960,13,90,10,1,C
230A,230A,15,969,1008,39,90,10,1,C
230A,230A,15,1019,1044,25,90,10,1,C
230A,230A,15,1053,1063,10,90,10,1,C
230A,230A,15,1075,1117,42,90,10,1,C
230A,230A,15,1130,1145,15,90,10,1,C
230A,230A,15,1190,1201,11,90,10,1,C
230A,230A,15,1215,1246,31,90,10,1,C
230A,230A,15,1279,1303,24,90,10,1,C
230A,230A,15,1387,1403,16,90,10,1,C
230A,230A,15,1425,1452,27,90,10,1,C
230A,230A,15,1460,1486,26,90,10,1,C
230A,230A,15,1491,1532,41,90,10,1,C
230A,230A,15,1536,1592,56,90,10,1,C
230A,230A,15,1632,1672,40,90,10,1,C
230A,230A,15,1697,1739,42,90,10,1,C
230A,230A,15,1772,1786,14,90,10,1,C
230A,230A,15,1790,1826,36,90,10,1,C
230A,230A,15,1850,1862,12,90,10,1,C
230A,230A,15,1871,1942,71,90,10,1,C
230A,230A,15,1956,1979,23,90,10,1,C
230A,230A,15,2039,2140,101,90,10,1,C
230A,230A,15,2207,2320,113,90,10,1,C
230A,230A,15,2391,2426,35,90,10,1,C
230A,230A,15,2440,2450,10,90,10,1,C
230A,230A,15,2470,2486,16,90,10,1,C
230A,230A,15,2544,2639,95,90,10,1,C
230A,230A,15,2674,2700,26,90,10,1,C
230A,230A,15,2766,2790,24,90,10,1,C
230A,230A,15,2798,2814,16,90,10,1,C
230A,230A,15,2864,2864,0,90,10,1,C
230A,230A,15,2948,2948,0,90,10,1,C
230A,230A,15,2972,2972,0,90,10,1,C
230A,230A,28,32,56,24,90,10,1,C
230A,230A,28,133,148,15,90,10,1,C
230A,230A,28,264,316,52,90,10,1,C
230A,230A,28,432,493,61,90,10,1,C
230A,230A,28,501,524,23,90,10,1,C
230A,230A,28,532,544,12,90,10,1,C
230A,230A,28,572,589,17,90,10,1,C
230A,230A,28,619,703,84,90,10,1,C
230A,230A,28,754,772,18,90,10,1,C
230A,230A,28,775,802,27,90,10,1,C
230A,230A,28,822,913,91,90,10,1,C
230A,230A,28,928,955,27,90,10,1,C
230A,230A,28,964,992,28,90,10,1,C
230A,230A,28,1002,1054,52,90,10,1,C
230A,230A,28,1080,1110,30,90,10,1,C
230A,230A,28,1113,1150,37,90,10,1,C
230A,230A,28,1159,1170,11,90,10,1,C
230A,230A,28,1194,1212,18,90,10,1,C
230A,230A,28,1221,1241,20,90,10,1,C
230A,230A,28,1421,1438,17,90,10,1,C
230A,230A,28,1509,1539,30,90,10,1,C
230A,230A,28,1584,1632,48,90,10,1,C
230A,230A,28,1719,1755,36,90,10,1,C
230A,230A,28,1836,1873,37,90,10,1,C
230A,230A,28,1892,1927,35,90,10,1,C
230A,230A,28,1938,1958,20,90,10,1,C
230A,230A,28,1992,2020,28,90,10,1,C
230A,230A,28,2039,2051,12,90,10,1,C
230A,230A,28,2060,2085,25,90,10,1,C
230A,230A,28,2120,2151,31,90,10,1,C
230A,230A,28,2162,2183,21,90,10,1,C
230A,230A,28,2198,2238,40,90,10,1,C
230A,230A,28,2361,2439,78,90,10,1,C
230A,230A,28,2574,2670,96,90,10,1,C
230A,230A,28,2742,2902,160,90,10,1,C
230A,230A,28,2942,2971,29,90,10,1,C
230G,230G,2,2,18,16,90,10,1,C
230G,230G,2,78,109,31,90,10,1,C
230G,230G,2,133,150,17,90,10,1,C
230G,230G,2,160,174,14,90,10,1,C
230G,230G,2,214,271,57,90,10,1,C
230G,230G,2,313,370,57,90,10,1,C
230G,230G,2,391,440,49,90,10,1,C
230G,230G,2,447,485,38,90,10,1,C
230G,230G,2,492,518,26,90,10,1,C
230G,230G,2,521,536,15,90,10,1,C
230G,230G,2,565,581,16,90,10,1,C
230G,230G,2,604,623,19,90,10,1,C
230G,230G,2,650,662,12,90,10,1,C
230G,230G,2,667,712,45,90,10,1,C
230G,230G,2,716,779,63,90,10,1,C
230G,230G,2,805,821,16,90,10,1,C
230G,230G,2,849,879,30,90,10,1,C
230G,230G,2,926,949,23,90,10,1,C
230G,230G,2,974,985,11,90,10,1,C
230G,230G,2,1035,1045,10,90,10,1,C
230G,230G,2,1107,1114,7,90,10,1,C
230G,230G,2,1128,1134,6,90,10,1,C
230G,230G,2,1185,1205,20,90,10,1,C
230G,230G,2,1258,1265,7,90,10,1,C
230G,230G,2,1291,1297,6,90,10,1,C
230G,230G,2,1324,1475,151,90,10,1,C
230G,230G,2,1502,1505,3,90,10,1,C
230G,230G,2,1523,1538,15,90,10,1,C
230G,230G,2,1556,1570,14,90,10,1,C
230G,230G,2,1611,1632,21,90,10,1,C
230G,230G,2,1651,1673,22,90,10,1,C
230G,230G,2,1682,1695,13,90,10,1,C
230G,230G,2,1726,1793,67,90,10,1,C
230G,230G,2,1906,1933,27,90,10,1,C
230G,230G,2,1941,1952,11,90,10,1,C
230G,230G,2,1959,1987,28,90,10,1,C
230G,230G,2,1998,2013,15,90,10,1,C
230G,230G,2,2029,2063,34,90,10,1,C
230G,230G,2,2084,2106,22,90,10,1,C
230G,230G,2,2134,2201,67,90,10,1,C
230G,230G,2,2203,2215,12,90,10,1,C
230G,230G,2,2218,2255,37,90,10,1,C
230G,230G,2,2267,2282,15,90,10,1,C
230G,230G,2,2287,2312,25,90,10,1,C
230G,230G,2,2321,2344,23,90,10,1,C
230G,230G,2,2354,2374,20,90,10,1,C
230G,230G,2,2414,2428,14,90,10,1,C
230G,230G,2,2459,2484,25,90,10,1,C
230G,230G,2,2545,2560,15,90,10,1,C
230G,230G,2,2624,2641,17,90,10,1,C
230G,230G,2,2760,2773,13,90,10,1,C
230G,230G,2,2932,2952,20,90,10,1,C
230G,230G,2,2972,2986,14,90,10,1,C
230G,230G,2,2988,3000,12,90,10,1,C
230G,230G,15,50,74,24,90,10,1,C
230G,230G,15,92,110,18,90,10,1,C
230G,230G,15,135,228,93,90,10,1,C
230G,230G,15,247,341,94,90,10,1,C
230G,230G,15,354,455,101,90,10,1,C
230G,230G,15,470,598,128,90,10,1,C
230G,230G,15,509,562,53,90,10,1,C
230G,230G,15,574,682,108,90,10,1,C
230G,230G,15,686,712,26,90,10,1,C
230G,230G,15,728,775,47,90,10,1,C
230G,230G,15,778,819,41,90,10,1,C
230G,230G,15,834,890,56,90,10,1,C
230G,230G,15,899,915,16,90,10,1,C
230G,230G,15,925,955,30,90,10,1,C
230G,230G,15,1010,1173,163,90,10,1,C
230G,230G,15,1179,1226,47,90,10,1,C
230G,230G,15,1235,1250,15,90,10,1,C
230G,230G,15,1256,1282,26,90,10,1,C
230G,230G,15,1301,1362,61,90,10,1,C
230G,230G,15,1373,1416,43,90,10,1,C
230G,230G,15,1449,1538,89,90,10,1,C
230G,230G,15,1550,1746,196,90,10,1,C
230G,230G,15,1788,1812,24,90,10,1,C
230G,230G,15,1855,1948,93,90,10,1,C
230G,230G,15,1964,1984,20,90,10,1,C
230G,230G,15,2005,2015,10,90,10,1,C
230G,230G,15,2023,2076,53,90,10,1,C
230G,230G,15,2082,2105,23,90,10,1,C
230G,230G,15,2113,2157,44,90,10,1,C
230G,230G,15,2164,2179,15,90,10,1,C
230G,230G,15,2245,2294,49,90,10,1,C
230G,230G,15,2319,2346,27,90,10,1,C
230G,230G,15,2353,2378,25,90,10,1,C
230G,230G,15,2436,2454,18,90,10,1,C
230G,230G,15,2464,2561,97,90,10,1,C
230G,230G,15,2574,2622,48,90,10,1,C
230G,230G,15,2630,2681,51,90,10,1,C
230G,230G,15,2696,2779,83,90,10,1,C
230G,230G,15,2845,2875,30,90,10,1,C
230G,230G,15,2881,2914,33,90,10,1,C
230G,230G,15,2925,2972,47,90,10,1,C
230G,230G,28,0,12,12,90,10,1,C
230G,230G,28,42,55,13,90,10,1,C
230G,230G,28,60,76,16,90,10,1,C
230G,230G,28,84,100,16,90,10,1,C
230G,230G,28,111,158,47,90,10,1,C
230G,230G,28,196,217,21,90,10,1,C
230G,230G,28,226,236,10,90,10,1,C
230G,230G,28,264,302,38,90,10,1,C
230G,230G,28,306,323,17,90,10,1,C
230G,230G,28,331,359,28,90,10,1,C
230G,230G,28,391,402,11,90,10,1,C
230G,230G,28,407,424,17,90,10,1,C
230G,230G,28,468,482,14,90,10,1,C
230G,230G,28,501,519,18,90,10,1,C
230G,230G,28,571,642,71,90,10,1,C
230G,230G,28,654,756,102,90,10,1,C
230G,230G,28,763,837,74,90,10,1,C
230G,230G,28,867,901,34,90,10,1,C
230G,230G,28,924,962,38,90,10,1,C
230G,230G,28,998,1022,24,90,10,1,C
230G,230G,28,1049,1090,41,90,10,1,C
230G,230G,28,1104,1134,30,90,10,1,C
230G,230G,28,1152,1187,35,90,10,1,C
230G,230G,28,1190,1232,42,90,10,1,C
230G,230G,28,1290,1321,31,90,10,1,C
230G,230G,28,1336,1351,15,90,10,1,C
230G,230G,28,1354,1360,6,90,10,1,C
230G,230G,28,1430,1458,28,90,10,1,C
230G,230G,28,1464,1495,31,90,10,1,C
230G,230G,28,1502,1543,41,90,10,1,C
230G,230G,28,1550,1562,12,90,10,1,C
230G,230G,28,1571,1610,39,90,10,1,C
230G,230G,28,1628,1647,19,90,10,1,C
230G,230G,28,1680,1696,16,90,10,1,C
230G,230G,28,1745,1774,29,90,10,1,C
230G,230G,28,1785,1820,35,90,10,1,C
230G,230G,28,1852,1867,15,90,10,1,C
230G,230G,28,1872,1900,28,90,10,1,C
230G,230G,28,1904,1951,47,90,10,1,C
230G,230G,28,2003,2015,12,90,10,1,C
230G,230G,28,2021,2032,11,90,10,1,C
230G,230G,28,2074,2102,28,90,10,1,C
230G,230G,28,2124,2142,18,90,10,1,C
230G,230G,28,2176,2200,24,90,10,1,C
230G,230G,28,2215,2227,12,90,10,1,C
230G,230G,28,2249,2278,29,90,10,1,C
230G,230G,28,2332,2373,41,90,10,1,C
230G,230G,28,2375,2394,19,90,10,1,C
230G,230G,28,2402,2413,11,90,10,1,C
230G,230G,28,2432,2455,23,90,10,1,C
230G,230G,28,2465,2504,39,90,10,1,C
230G,230G,28,2526,2576,50,90,10,1,C
230G,230G,28,2586,2599,13,90,10,1,C
230G,230G,28,2609,2650,41,90,10,1,C
230G,230G,28,2658,2682,24,90,10,1,C
230G,230G,28,2697,2720,23,90,10,1,C
230G,230G,28,2734,2749,15,90,10,1,C
230G,230G,28,2755,2790,35,90,10,1,C
230G,230G,28,2904,2916,12,90,10,1,C
230G,230G,28,2964,2989,25,90,10,1,C
231A,231A,2,103,135,32,90,10,1,C
231A,231A,2,1225,1236,11,90,10,1,C
231A,231A,2,1260,1272,12,90,10,1,C
231A,231A,2,1339,1340,1,90,10,1,C
231A,231A,2,1375,1389,14,90,10,1,C
231A,231A,2,1440,1455,15,90,10,1,C
231A,231A,2,1545,1555,10,90,10,1,C
231A,231A,2,1611,1640,29,90,10,1,C
231A,231A,2,1894,1915,21,90,10,1,C
231A,231A,2,1968,1986,18,90,10,1,C
231A,231A,2,2013,2060,47,90,10,1,C
231A,231A,2,2184,2200,16,90,10,1,C
231A,231A,2,2320,2350,30,90,10,1,C
231A,231A,2,2410,2431,21,90,10,1,C
231A,231A,2,2549,2567,18,90,10,1,C
231A,231A,2,2766,2782,16,90,10,1,C
231A,231A,15,528,538,10,90,10,1,C
231A,231A,15,716,739,23,90,10,1,C
231A,231A,15,949,966,17,90,10,1,C
231A,231A,15,974,985,11,90,10,1,C
231A,231A,15,1085,1099,14,90,10,1,C
231A,231A,15,1986,2013,27,90,10,1,C
231A,231A,15,2030,2044,14,90,10,1,C
231A,231A,15,2190,2251,61,90,10,1,C
231A,231A,15,2358,2370,12,90,10,1,C
231A,231A,15,2656,2681,25,90,10,1,C
231A,231A,15,2838,2848,10,90,10,1,C
231A,231A,15,2853,2881,28,90,10,1,C
231A,231A,15,2928,2940,12,90,10,1,C
231A,231A,28,106,121,15,90,10,1,C
231A,231A,28,244,260,16,90,10,1,C
231A,231A,28,282,298,16,90,10,1,C
231A,231A,28,846,886,40,90,10,1,C
231A,231A,28,905,926,21,90,10,1,C
231A,231A,28,1537,1560,23,90,10,1,C
231A,231A,28,1700,1752,52,90,10,1,C
231A,231A,28,2248,2260,12,90,10,1,C
231A,231A,28,2548,2589,41,90,10,1,C
231G,231G,2,40,63,23,90,10,1,C
231G,231G,2,109,121,12,90,10,1,C
231G,231G,2,168,184,16,90,10,1,C
231G,231G,2,189,200,11,90,10,1,C
231G,231G,2,346,357,11,90,10,1,C
231G,231G,2,364,380,16,90,10,1,C
231G,231G,2,718,736,18,90,10,1,C
231G,231G,2,774,792,18,90,10,1,C
231G,231G,2,940,953,13,90,10,1,C
231G,231G,2,1024,1038,14,90,10,1,C
231G,231G,2,1107,1122,15,90,10,1,C
231G,231G,2,1264,1279,15,90,10,1,C
231G,231G,2,1285,1296,11,90,10,1,C
231G,231G,2,1816,1827,11,90,10,1,C
231G,231G,2,2062,2091,29,90,10,1,C
231G,231G,2,2129,2146,17,90,10,1,C
231G,231G,2,2556,2568,12,90,10,1,C
231G,231G,2,2605,2620,15,90,10,1,C
231G,231G,2,2835,2847,12,90,10,1,C
231G,231G,2,2889,2903,14,90,10,1,C
231G,231G,15,54,73,19,90,10,1,C
231G,231G,15,471,503,32,90,10,1,C
231G,231G,15,525,567,42,90,10,1,C
231G,231G,15,575,587,12,90,10,1,C
231G,231G,15,595,633,38,90,10,1,C
231G,231G,15,647,674,27,90,10,1,C
231G,231G,15,743,761,18,90,10,1,C
231G,231G,15,937,1022,85,90,10,1,C
231G,231G,15,1360,1377,17,90,10,1,C
231G,231G,15,1385,1397,12,90,10,1,C
231G,231G,15,1576,1588,12,90,10,1,C
231G,231G,15,1692,1712,20,90,10,1,C
231G,231G,15,2499,2511,12,90,10,1,C
231G,231G,15,2550,2603,53,90,10,1,C
231G,231G,15,2612,2643,31,90,10,1,C
231G,231G,15,2729,2774,45,90,10,1,C
231G,231G,15,2792,2807,15,90,10,1,C
231G,231G,15,2812,2847,35,90,10,1,C
231G,231G,15,2856,2916,60,90,10,1,C
231G,231G,15,2954,2965,11,90,10,1,C
231G,231G,28,453,471,18,90,10,1,C
231G,231G,28,490,542,52,90,10,1,C
231G,231G,28,549,563,14,90,10,1,C
231G,231G,28,670,688,18,90,10,1,C
231G,231G,28,1050,1070,20,90,10,1,C
231G,231G,28,1152,1175,23,90,10,1,C
231G,231G,28,1183,1203,20,90,10,1,C
231G,231G,28,1243,1256,13,90,10,1,C
231G,231G,28,1495,1430,-65,90,10,1,C
231G,231G,28,1769,1795,26,90,10,1,C
231G,231G,28,2012,2041,29,90,10,1,C
231G,231G,28,2102,2128,26,90,10,1,C
231G,231G,28,2490,2515,25,90,10,1,C
231G,231G,28,2556,2577,21,90,10,1,C
231G,231G,28,2899,2920,21,90,10,1,C
232A,232A,2,53,66,13,90,10,1,C
232A,232A,2,100,132,32,90,10,1,C
232A,232A,2,200,221,21,90,10,1,C
232A,232A,2,453,478,25,90,10,1,C
232A,232A,2,558,578,20,90,10,1,C
232A,232A,2,625,644,19,90,10,1,C
232A,232A,2,716,775,59,90,10,1,C
232A,232A,2,800,817,17,90,10,1,C
232A,232A,2,972,990,18,90,10,1,C
232A,232A,2,1258,1295,37,90,10,1,C
232A,232A,2,1633,1645,12,90,10,1,C
232A,232A,2,1652,1685,33,90,10,1,C
232A,232A,2,1709,1740,31,90,10,1,C
232A,232A,2,1904,1946,42,90,10,1,C
232A,232A,2,1964,1992,28,90,10,1,C
232A,232A,2,2165,2223,58,90,10,1,C
232A,232A,2,2316,2430,114,90,10,1,C
232A,232A,2,2461,2508,47,90,10,1,C
232A,232A,2,2528,2553,25,90,10,1,C
232A,232A,2,2720,2756,36,90,10,1,C
232A,232A,2,2785,2807,22,90,10,1,C
232A,232A,15,0,26,26,90,10,1,C
232A,232A,15,35,49,14,90,10,1,C
232A,232A,15,58,83,25,90,10,1,C
232A,232A,15,220,250,30,90,10,1,C
232A,232A,15,260,272,12,90,10,1,C
232A,232A,15,295,338,43,90,10,1,C
232A,232A,15,795,810,15,90,10,1,C
232A,232A,15,1125,1142,17,90,10,1,C
232A,232A,15,1600,1617,17,90,10,1,C
232A,232A,15,1713,1731,18,90,10,1,C
232A,232A,15,2173,2203,30,90,10,1,C
232A,232A,15,2333,2358,25,90,10,1,C
232A,232A,15,2462,2498,36,90,10,1,C
232A,232A,15,2525,2543,18,90,10,1,C
232A,232A,15,2835,2877,42,90,10,1,C
232A,232A,28,105,119,14,90,10,1,C
232A,232A,28,145,163,18,90,10,1,C
232A,232A,28,380,395,15,90,10,1,C
232A,232A,28,403,432,29,90,10,1,C
232A,232A,28,462,486,24,90,10,1,C
232A,232A,28,726,760,34,90,10,1,C
232A,232A,28,871,887,16,90,10,1,C
232A,232A,28,928,944,16,90,10,1,C
232A,232A,28,1045,1062,17,90,10,1,C
232A,232A,28,1208,1255,47,90,10,1,C
232A,232A,28,1403,1430,27,90,10,1,C
232A,232A,28,1464,1487,23,90,10,1,C
232A,232A,28,1513,1530,17,90,10,1,C
232A,232A,28,1670,1700,30,90,10,1,C
232A,232A,28,1821,1865,44,90,10,1,C
232A,232A,28,1971,2035,64,90,10,1,C
232A,232A,28,2074,2097,23,90,10,1,C
232A,232A,28,2110,2124,14,90,10,1,C
232A,232A,28,2129,2150,21,90,10,1,C
232A,232A,28,2230,2243,13,90,10,1,C
232A,232A,28,2280,2300,20,90,10,1,C
232A,232A,28,2401,2422,21,90,10,1,C
232A,232A,28,2439,2459,20,90,10,1,C
232A,232A,28,2501,2543,42,90,10,1,C
232A,232A,28,2600,2611,11,90,10,1,C
232A,232A,28,2650,2687,37,90,10,1,C
232A,232A,28,2702,2743,41,90,10,1,C
232A,232A,28,2770,2793,23,90,10,1,C
232A,232A,28,2859,2880,21,90,10,1,C
232A,232A,28,2942,2972,30,90,10,1,C
232G,232G,2,0,29,29,90,10,1,C
232G,232G,2,328,376,48,90,10,1,C
232G,232G,2,465,481,16,90,10,1,C
232G,232G,2,948,974,26,90,10,1,C
232G,232G,2,1220,1259,39,90,10,1,C
232G,232G,2,1490,1516,26,90,10,1,C
232G,232G,2,1526,1557,31,90,10,1,C
232G,232G,2,1609,1623,14,90,10,1,C
232G,232G,2,1795,1813,18,90,10,1,C
232G,232G,2,1952,1965,13,90,10,1,C
232G,232G,2,2380,2427,47,90,10,1,C
232G,232G,2,2770,2809,39,90,10,1,C
232G,232G,2,2844,2864,20,90,10,1,C
232G,232G,2,2901,2920,19,90,10,1,C
232G,232G,15,47,93,46,90,10,1,C
232G,232G,15,140,203,63,90,10,1,C
232G,232G,15,220,238,18,90,10,1,C
232G,232G,15,280,328,48,90,10,1,C
232G,232G,15,333,345,12,90,10,1,C
232G,232G,15,396,428,32,90,10,1,C
232G,232G,15,483,510,27,90,10,1,C
232G,232G,15,525,540,15,90,10,1,C
232G,232G,15,557,580,23,90,10,1,C
232G,232G,15,593,608,15,90,10,1,C
232G,232G,15,799,823,24,90,10,1,C
232G,232G,15,830,844,14,90,10,1,C
232G,232G,15,879,902,23,90,10,1,C
232G,232G,15,948,971,23,90,10,1,C
232G,232G,15,1010,1022,12,90,10,1,C
232G,232G,15,1170,1201,31,90,10,1,C
232G,232G,15,1566,1593,27,90,10,1,C
232G,232G,15,1644,1681,37,90,10,1,C
232G,232G,15,1736,1760,24,90,10,1,C
232G,232G,15,2173,2213,40,90,10,1,C
232G,232G,15,2360,2382,22,90,10,1,C
232G,232G,15,2768,2801,33,90,10,1,C
232G,232G,28,28,104,76,90,10,1,C
232G,232G,28,125,214,89,90,10,1,C
232G,232G,28,225,275,50,90,10,1,C
232G,232G,28,296,319,23,90,10,1,C
232G,232G,28,402,417,15,90,10,1,C
232G,232G,28,539,560,21,90,10,1,C
232G,232G,28,572,601,29,90,10,1,C
232G,232G,28,620,633,13,90,10,1,C
232G,232G,28,1052,1095,43,90,10,1,C
232G,232G,28,1228,1242,14,90,10,1,C
232G,232G,28,1251,1268,17,90,10,1,C
232G,232G,28,1291,1319,28,90,10,1,C
232G,232G,28,1413,1429,16,90,10,1,C
232G,232G,28,1775,1796,21,90,10,1,C
232G,232G,28,1838,1852,14,90,10,1,C
232G,232G,28,2290,2323,33,90,10,1,C
232G,232G,28,2353,2378,25,90,10,1,C
232G,232G,28,2450,2460,10,90,10,1,C
232G,232G,28,2665,2684,19,90,10,1,C
233A,233A,2,33,53,20,90,10,1,C
233A,233A,2,220,235,15,90,10,1,C
233A,233A,2,309,345,36,90,10,1,C
233A,233A,2,417,430,13,90,10,1,C
233A,233A,2,472,485,13,90,10,1,C
233A,233A,2,1351,1376,25,90,10,1,C
233A,233A,2,1554,1576,22,90,10,1,C
233A,233A,2,1655,1671,16,90,10,1,C
233A,233A,2,1702,1717,15,90,10,1,C
233A,233A,2,2415,2425,10,90,10,1,C
233A,233A,2,2598,2620,22,90,10,1,C
233A,233A,15,367,380,13,90,10,1,C
233A,233A,15,496,546,50,90,10,1,C
233A,233A,15,818,835,17,90,10,1,C
233A,233A,15,907,939,32,90,10,1,C
233A,233A,15,1085,1099,14,90,10,1,C
233A,233A,15,1115,1135,20,90,10,1,C
233A,233A,15,1195,1210,15,90,10,1,C
233A,233A,15,1232,1263,31,90,10,1,C
233A,233A,15,1288,1303,15,90,10,1,C
233A,233A,15,1336,1349,13,90,10,1,C
233A,233A,15,1479,1492,13,90,10,1,C
233A,233A,15,1690,1700,10,90,10,1,C
233A,233A,15,1733,1747,14,90,10,1,C
233A,233A,15,1767,1780,13,90,10,1,C
233A,233A,15,1826,1850,24,90,10,1,C
233A,233A,15,2710,2723,13,90,10,1,C
233A,233A,28,675,688,13,90,10,1,C
233A,233A,28,894,904,10,90,10,1,C
233G,233G,2,0,50,50,90,10,1,C
233G,233G,2,70,105,35,90,10,1,C
233G,233G,2,160,180,20,90,10,1,C
233G,233G,2,190,205,15,90,10,1,C
233G,233G,2,250,280,30,90,10,1,C
233G,233G,2,350,385,35,90,10,1,C
233G,233G,2,400,420,20,90,10,1,C
233G,233G,2,570,590,20,90,10,1,C
233G,233G,2,685,700,15,90,10,1,C
233G,233G,2,950,970,20,90,10,1,C
233G,233G,2,2575,2650,75,90,10,1,C
233G,233G,2,2780,2800,20,90,10,1,C
233G,233G,15,90,110,20,90,10,1,C
233G,233G,15,160,175,15,90,10,1,C
233G,233G,15,615,662,47,90,10,1,C
233G,233G,15,988,1040,52,90,10,1,C
233G,233G,15,1055,1076,21,90,10,1,C
233G,233G,15,1140,1155,15,90,10,1,C
233G,233G,15,1210,1239,29,90,10,1,C
233G,233G,15,1532,1555,23,90,10,1,C
233G,233G,15,1576,1610,34,90,10,1,C
233G,233G,15,1678,1710,32,90,10,1,C
233G,233G,15,1740,1870,130,90,10,1,C
233G,233G,15,1910,1930,20,90,10,1,C
233G,233G,15,1985,2020,35,90,10,1,C
233G,233G,15,2040,2070,30,90,10,1,C
233G,233G,15,2100,2140,40,90,10,1,C
233G,233G,15,2164,2242,78,90,10,1,C
233G,233G,15,2310,2336,26,90,10,1,C
233G,233G,15,2442,2505,63,90,10,1,C
233G,233G,15,2760,2775,15,90,10,1,C
233G,233G,15,2795,2810,15,90,10,1,C
233G,233G,15,2848,2875,27,90,10,1,C
233G,233G,15,2920,2945,25,90,10,1,C
233G,233G,28,334,400,66,90,10,1,C
233G,233G,28,425,460,35,90,10,1,C
233G,233G,28,480,572,92,90,10,1,C
233G,233G,28,625,700,75,90,10,1,C
233G,233G,28,824,852,28,90,10,1,C
233G,233G,28,952,1000,48,90,10,1,C
233G,233G,28,1081,1260,179,90,10,1,C
233G,233G,28,1410,1430,20,90,10,1,C
233G,233G,28,1580,1594,14,90,10,1,C
233G,233G,28,1615,1650,35,90,10,1,C
233G,233G,28,1670,1704,34,90,10,1,C
233G,233G,28,1762,1801,39,90,10,1,C
233G,233G,28,1835,1896,61,90,10,1,C
233G,233G,28,2370,2401,31,90,10,1,C
233G,233G,28,2435,2455,20,90,10,1,C
234A,234A,2,15,44,29,90,10,1,C
234A,234A,2,55,68,13,90,10,1,C
234A,234A,2,97,123,26,90,10,1,C
234A,234A,2,190,220,30,90,10,1,C
234A,234A,2,245,283,38,90,10,1,C
234A,234A,2,309,319,10,90,10,1,C
234A,234A,2,320,372,52,90,10,1,C
234A,234A,2,404,422,18,90,10,1,C
234A,234A,2,434,451,17,90,10,1,C
234A,234A,2,475,490,15,90,10,1,C
234A,234A,2,498,532,34,90,10,1,C
234A,234A,2,541,571,30,90,10,1,C
234A,234A,2,596,639,43,90,10,1,C
234A,234A,2,643,664,21,90,10,1,C
234A,234A,2,675,694,19,90,10,1,C
234A,234A,2,712,753,41,90,10,1,C
234A,234A,2,821,839,18,90,10,1,C
234A,234A,2,863,881,18,90,10,1,C
234A,234A,2,888,927,39,90,10,1,C
234A,234A,2,953,965,12,90,10,1,C
234A,234A,2,972,989,17,90,10,1,C
234A,234A,2,1005,1030,25,90,10,1,C
234A,234A,2,1215,1232,17,90,10,1,C
234A,234A,2,1245,1260,15,90,10,1,C
234A,234A,2,1280,1302,22,90,10,1,C
234A,234A,2,1414,1428,14,90,10,1,C
234A,234A,2,1494,1511,17,90,10,1,C
234A,234A,2,1591,1620,29,90,10,1,C
234A,234A,2,1637,1664,27,90,10,1,C
234A,234A,2,1700,1716,16,90,10,1,C
234A,234A,2,1748,1775,27,90,10,1,C
234A,234A,2,1807,1831,24,90,10,1,C
234A,234A,2,1959,1992,33,90,10,1,C
234A,234A,2,2005,2047,42,90,10,1,C
234A,234A,2,2054,2198,144,90,10,1,C
234A,234A,2,2203,2219,16,90,10,1,C
234A,234A,2,2295,2319,24,90,10,1,C
234A,234A,2,2538,2569,31,90,10,1,C
234A,234A,2,2609,2623,14,90,10,1,C
234A,234A,2,2632,2644,12,90,10,1,C
234A,234A,2,2655,2669,14,90,10,1,C
234A,234A,2,2707,2747,40,90,10,1,C
234A,234A,2,2780,2816,36,90,10,1,C
234A,234A,2,2935,2954,19,90,10,1,C
234A,234A,2,2959,2977,18,90,10,1,C
234A,234A,15,90,102,12,90,10,1,C
234A,234A,15,143,160,17,90,10,1,C
234A,234A,15,835,849,14,90,10,1,C
234A,234A,15,911,924,13,90,10,1,C
234A,234A,15,1071,1085,14,90,10,1,C
234A,234A,15,1179,1195,16,90,10,1,C
234A,234A,15,1416,1426,10,90,10,1,C
234A,234A,15,1619,1629,10,90,10,1,C
234A,234A,15,1750,1771,21,90,10,1,C
234A,234A,15,1914,1929,15,90,10,1,C
234A,234A,15,1943,1964,21,90,10,1,C
234A,234A,15,2004,2019,15,90,10,1,C
234A,234A,15,2054,2073,19,90,10,1,C
234A,234A,15,2095,2119,24,90,10,1,C
234A,234A,15,2508,2526,18,90,10,1,C
234A,234A,15,2562,2577,15,90,10,1,C
234A,234A,15,2851,2870,19,90,10,1,C
234A,234A,28,19,38,19,90,10,1,C
234A,234A,28,55,66,11,90,10,1,C
234A,234A,28,299,334,35,90,10,1,C
234A,234A,28,374,386,12,90,10,1,C
234A,234A,28,419,437,18,90,10,1,C
234A,234A,28,472,496,24,90,10,1,C
234A,234A,28,612,637,25,90,10,1,C
234A,234A,28,820,850,30,90,10,1,C
234A,234A,28,910,931,21,90,10,1,C
234A,234A,28,984,1000,16,90,10,1,C
234A,234A,28,1256,1274,18,90,10,1,C
234A,234A,28,1298,1353,55,90,10,1,C
234A,234A,28,1415,1440,25,90,10,1,C
234A,234A,28,1451,1490,39,90,10,1,C
234A,234A,28,1506,1520,14,90,10,1,C
234A,234A,28,1525,1553,28,90,10,1,C
234A,234A,28,1575,1588,13,90,10,1,C
234A,234A,28,1698,1719,21,90,10,1,C
234A,234A,28,1900,1924,24,90,10,1,C
234A,234A,28,2040,2053,13,90,10,1,C
234A,234A,28,2082,2111,29,90,10,1,C
234A,234A,28,2116,2150,34,90,10,1,C
234A,234A,28,2250,2270,20,90,10,1,C
234A,234A,28,2279,2290,11,90,10,1,C
234A,234A,28,2310,2333,23,90,10,1,C
234A,234A,28,2357,2374,17,90,10,1,C
234A,234A,28,2472,2529,57,90,10,1,C
234A,234A,28,2581,2602,21,90,10,1,C
234A,234A,28,2644,2664,20,90,10,1,C
234A,234A,28,2679,2702,23,90,10,1,C
234A,234A,28,2745,2761,16,90,10,1,C
234A,234A,28,2777,2793,16,90,10,1,C
234A,234A,28,2841,2853,12,90,10,1,C
234A,234A,28,2916,2933,17,90,10,1,C
234A,234A,28,2951,2962,11,90,10,1,C
234G,234G,2,73,91,18,90,10,1,C
234G,234G,2,120,148,28,90,10,1,C
234G,234G,2,370,378,8,90,10,1,C
234G,234G,2,445,458,13,90,10,1,C
234G,234G,2,490,527,37,90,10,1,C
234G,234G,2,549,575,26,90,10,1,C
234G,234G,2,647,659,12,90,10,1,C
234G,234G,2,682,695,13,90,10,1,C
234G,234G,2,732,744,12,90,10,1,C
234G,234G,2,805,844,39,90,10,1,C
234G,234G,2,884,905,21,90,10,1,C
234G,234G,2,936,966,30,90,10,1,C
234G,234G,2,1071,1121,50,90,10,1,C
234G,234G,2,1158,1175,17,90,10,1,C
234G,234G,2,1222,1234,12,90,10,1,C
234G,234G,2,1243,1260,17,90,10,1,C
234G,234G,2,1265,1275,10,90,10,1,C
234G,234G,2,1288,1320,32,90,10,1,C
234G,234G,2,1340,1352,12,90,10,1,C
234G,234G,2,1398,1434,36,90,10,1,C
234G,234G,2,1454,1515,61,90,10,1,C
234G,234G,2,1535,1587,52,90,10,1,C
234G,234G,2,1603,1632,29,90,10,1,C
234G,234G,2,1720,1735,15,90,10,1,C
234G,234G,2,1740,1756,16,90,10,1,C
234G,234G,2,1910,1928,18,90,10,1,C
234G,234G,2,1995,2014,19,90,10,1,C
234G,234G,2,2060,2076,16,90,10,1,C
234G,234G,2,2445,2458,13,90,10,1,C
234G,234G,2,2550,2577,27,90,10,1,C
234G,234G,15,15,43,28,90,10,1,C
234G,234G,15,103,123,20,90,10,1,C
234G,234G,15,137,149,12,90,10,1,C
234G,234G,15,154,172,18,90,10,1,C
234G,234G,15,180,194,14,90,10,1,C
234G,234G,15,244,258,14,90,10,1,C
234G,234G,15,272,302,30,90,10,1,C
234G,234G,15,413,427,14,90,10,1,C
234G,234G,15,468,481,13,90,10,1,C
234G,234G,15,489,502,13,90,10,1,C
234G,234G,15,536,558,22,90,10,1,C
234G,234G,15,601,642,41,90,10,1,C
234G,234G,15,673,721,48,90,10,1,C
234G,234G,15,735,757,22,90,10,1,C
234G,234G,15,881,895,14,90,10,1,C
234G,234G,15,1349,1373,24,90,10,1,C
234G,234G,15,1376,1386,10,90,10,1,C
234G,234G,15,1407,1417,10,90,10,1,C
234G,234G,15,1428,1454,26,90,10,1,C
234G,234G,15,1463,1499,36,90,10,1,C
234G,234G,15,1529,1550,21,90,10,1,C
234G,234G,15,1568,1581,13,90,10,1,C
234G,234G,15,1646,1665,19,90,10,1,C
234G,234G,15,1679,1696,17,90,10,1,C
234G,234G,15,2147,2160,13,90,10,1,C
234G,234G,15,2183,2208,25,90,10,1,C
234G,234G,15,2243,2266,23,90,10,1,C
234G,234G,15,2279,2290,11,90,10,1,C
234G,234G,15,2293,2313,20,90,10,1,C
234G,234G,15,2319,2346,27,90,10,1,C
234G,234G,15,2721,2734,13,90,10,1,C
234G,234G,15,2802,2815,13,90,10,1,C
234G,234G,15,2829,2855,26,90,10,1,C
234G,234G,15,2867,2880,13,90,10,1,C
234G,234G,15,2902,2915,13,90,10,1,C
234G,234G,28,0,17,17,90,10,1,C
234G,234G,28,155,280,125,90,10,1,C
234G,234G,28,190,304,114,90,10,1,C
234G,234G,28,399,412,13,90,10,1,C
234G,234G,28,413,443,30,90,10,1,C
234G,234G,28,641,656,15,90,10,1,C
234G,234G,28,667,686,19,90,10,1,C
234G,234G,28,740,771,31,90,10,1,C
234G,234G,28,790,803,13,90,10,1,C
234G,234G,28,811,847,36,90,10,1,C
234G,234G,28,862,910,48,90,10,1,C
234G,234G,28,916,929,13,90,10,1,C
234G,234G,28,1140,1161,21,90,10,1,C
234G,234G,28,1206,1223,17,90,10,1,C
234G,234G,28,1271,1285,14,90,10,1,C
234G,234G,28,1365,1390,25,90,10,1,C
234G,234G,28,1618,1636,18,90,10,1,C
234G,234G,28,1641,1666,25,90,10,1,C
234G,234G,28,1890,1908,18,90,10,1,C
234G,234G,28,1913,1936,23,90,10,1,C
234G,234G,28,1998,2020,22,90,10,1,C
234G,234G,28,2025,2051,26,90,10,1,C
234G,234G,28,2118,2148,30,90,10,1,C
234G,234G,28,2185,2205,20,90,10,1,C
234G,234G,28,2210,2235,25,90,10,1,C
234G,234G,28,2243,2274,31,90,10,1,C
234G,234G,28,2280,2315,35,90,10,1,C
234G,234G,28,2366,2413,47,90,10,1,C
234G,234G,28,2422,2439,17,90,10,1,C
234G,234G,28,2472,2490,18,90,10,1,C
234G,234G,28,2594,2609,15,90,10,1,C
234G,234G,28,2663,2680,17,90,10,1,C
234G,234G,28,2863,2877,14,90,10,1,C
235A,235A,2,0,12,12,90,10,1,C
235A,235A,2,59,180,121,90,10,1,C
235A,235A,2,224,243,19,90,10,1,C
235A,235A,2,258,272,14,90,10,1,C
235A,235A,2,311,335,24,90,10,1,C
235A,235A,2,364,394,30,90,10,1,C
235A,235A,2,538,556,18,90,10,1,C
235A,235A,2,562,582,20,90,10,1,C
235A,235A,2,602,646,44,90,10,1,C
235A,235A,2,652,663,11,90,10,1,C
235A,235A,2,678,690,12,90,10,1,C
235A,235A,2,805,820,15,90,10,1,C
235A,235A,2,909,920,11,90,10,1,C
235A,235A,2,1006,1021,15,90,10,1,C
235A,235A,2,1025,1039,14,90,10,1,C
235A,235A,2,1169,1182,13,90,10,1,C
235A,235A,2,1197,1229,32,90,10,1,C
235A,235A,2,1238,1271,33,90,10,1,C
235A,235A,2,1276,1303,27,90,10,1,C
235A,235A,2,1316,1340,24,90,10,1,C
235A,235A,2,1342,1390,48,90,10,1,C
235A,235A,2,1471,1489,18,90,10,1,C
235A,235A,2,1509,1522,13,90,10,1,C
235A,235A,2,1569,1579,10,90,10,1,C
235A,235A,2,1612,1630,18,90,10,1,C
235A,235A,2,1650,1663,13,90,10,1,C
235A,235A,2,1721,1746,25,90,10,1,C
235A,235A,2,1806,1821,15,90,10,1,C
235A,235A,2,1829,1841,12,90,10,1,C
235A,235A,2,1876,1894,18,90,10,1,C
235A,235A,2,1919,1942,23,90,10,1,C
235A,235A,2,1952,1985,33,90,10,1,C
235A,235A,2,2034,2061,27,90,10,1,C
235A,235A,2,2089,2106,17,90,10,1,C
235A,235A,2,2121,2135,14,90,10,1,C
235A,235A,2,2239,2258,19,90,10,1,C
235A,235A,2,2261,2276,15,90,10,1,C
235A,235A,2,2389,2403,14,90,10,1,C
235A,235A,2,2424,2439,15,90,10,1,C
235A,235A,2,2462,2473,11,90,10,1,C
235A,235A,2,2559,2571,12,90,10,1,C
235A,235A,2,2594,2614,20,90,10,1,C
235A,235A,2,2654,2672,18,90,10,1,C
235A,235A,2,2680,2715,35,90,10,1,C
235A,235A,2,2722,2743,21,90,10,1,C
235A,235A,2,2776,2789,13,90,10,1,C
235A,235A,2,2811,2821,10,90,10,1,C
235A,235A,2,2902,2914,12,90,10,1,C
235A,235A,2,2940,2962,22,90,10,1,C
235A,235A,15,0,13,13,90,10,1,C
235A,235A,15,16,31,15,90,10,1,C
235A,235A,15,67,77,10,90,10,1,C
235A,235A,15,80,92,12,90,10,1,C
235A,235A,15,170,206,36,90,10,1,C
235A,235A,15,216,227,11,90,10,1,C
235A,235A,15,408,424,16,90,10,1,C
235A,235A,15,559,580,21,90,10,1,C
235A,235A,15,662,682,20,90,10,1,C
235A,235A,15,890,902,12,90,10,1,C
235A,235A,15,915,937,22,90,10,1,C
235A,235A,15,1011,1022,11,90,10,1,C
235A,235A,15,1220,1230,10,90,10,1,C
235A,235A,15,1321,1343,22,90,10,1,C
235A,235A,15,1681,1704,23,90,10,1,C
235A,235A,15,1739,1771,32,90,10,1,C
235A,235A,15,1999,2023,24,90,10,1,C
235A,235A,15,2120,2131,11,90,10,1,C
235A,235A,15,2302,2316,14,90,10,1,C
235A,235A,15,2479,2505,26,90,10,1,C
235A,235A,15,2559,2571,12,90,10,1,C
235A,235A,15,2595,2615,20,90,10,1,C
235A,235A,15,2875,2901,26,90,10,1,C
235A,235A,15,2934,2951,17,90,10,1,C
235A,235A,28,1,16,15,90,10,1,C
235A,235A,28,20,35,15,90,10,1,C
235A,235A,28,165,177,12,90,10,1,C
235A,235A,28,185,200,15,90,10,1,C
235A,235A,28,306,320,14,90,10,1,C
235A,235A,28,340,351,11,90,10,1,C
235A,235A,28,665,675,10,90,10,1,C
235A,235A,28,797,810,13,90,10,1,C
235A,235A,28,812,831,19,90,10,1,C
235A,235A,28,922,936,14,90,10,1,C
235A,235A,28,988,1013,25,90,10,1,C
235A,235A,28,1016,1030,14,90,10,1,C
235A,235A,28,1260,1288,28,90,10,1,C
235A,235A,28,1292,1320,28,90,10,1,C
235A,235A,28,1325,1353,28,90,10,1,C
235A,235A,28,1361,1384,23,90,10,1,C
235A,235A,28,1456,1480,24,90,10,1,C
235A,235A,28,1546,1580,34,90,10,1,C
235A,235A,28,1585,1612,27,90,10,1,C
235A,235A,28,1635,1653,18,90,10,1,C
235A,235A,28,1676,1690,14,90,10,1,C
235A,235A,28,1712,1746,34,90,10,1,C
235A,235A,28,1792,1806,14,90,10,1,C
235A,235A,28,1825,1840,15,90,10,1,C
235A,235A,28,1845,1859,14,90,10,1,C
235A,235A,28,1938,1949,11,90,10,1,C
235A,235A,28,1964,1979,15,90,10,1,C
235A,235A,28,2012,2022,10,90,10,1,C
235A,235A,28,2088,2140,52,90,10,1,C
235A,235A,28,2146,2166,20,90,10,1,C
235A,235A,28,2176,2200,24,90,10,1,C
235A,235A,28,2215,2229,14,90,10,1,C
235A,235A,28,2310,2322,12,90,10,1,C
235A,235A,28,2342,2380,38,90,10,1,C
235A,235A,28,2400,2432,32,90,10,1,C
235A,235A,28,2453,2457,4,90,10,1,C
235A,235A,28,2513,2530,17,90,10,1,C
235A,235A,28,2560,2582,22,90,10,1,C
235A,235A,28,2592,2626,34,90,10,1,C
235A,235A,28,2641,2654,13,90,10,1,C
235A,235A,28,2684,2709,25,90,10,1,C
235A,235A,28,2731,2749,18,90,10,1,C
235A,235A,28,2788,2806,18,90,10,1,C
235A,235A,28,2821,2836,15,90,10,1,C
235A,235A,28,2842,2870,28,90,10,1,C
235A,235A,28,2889,2910,21,90,10,1,C
235A,235A,28,2969,2984,15,90,10,1,C
235G,235G,2,311,330,19,90,10,1,C
235G,235G,2,346,365,19,90,10,1,C
235G,235G,2,378,395,17,90,10,1,C
235G,235G,2,467,479,12,90,10,1,C
235G,235G,2,615,627,12,90,10,1,C
235G,235G,2,663,696,33,90,10,1,C
235G,235G,2,771,785,14,90,10,1,C
235G,235G,2,790,818,28,90,10,1,C
235G,235G,2,833,851,18,90,10,1,C
235G,235G,2,989,1005,16,90,10,1,C
235G,235G,2,1315,1326,11,90,10,1,C
235G,235G,2,1353,1365,12,90,10,1,C
235G,235G,2,1478,1489,11,90,10,1,C
235G,235G,2,1550,1571,21,90,10,1,C
235G,235G,2,1580,1613,33,90,10,1,C
235G,235G,2,1765,1783,18,90,10,1,C
235G,235G,2,2077,2097,20,90,10,1,C
235G,235G,2,2206,2223,17,90,10,1,C
235G,235G,2,2430,2442,12,90,10,1,C
235G,235G,2,2488,2500,12,90,10,1,C
235G,235G,2,2509,2533,24,90,10,1,C
235G,235G,2,2538,2578,40,90,10,1,C
235G,235G,2,2602,2625,23,90,10,1,C
235G,235G,2,2630,2665,35,90,10,1,C
235G,235G,2,2820,2836,16,90,10,1,C
235G,235G,2,2889,2908,19,90,10,1,C
235G,235G,2,2918,2936,18,90,10,1,C
235G,235G,2,2987,3000,13,90,10,1,C
235G,235G,15,0,13,13,90,10,1,C
235G,235G,15,521,531,10,90,10,1,C
235G,235G,15,591,602,11,90,10,1,C
235G,235G,15,643,656,13,90,10,1,C
235G,235G,15,708,765,57,90,10,1,C
235G,235G,15,771,821,50,90,10,1,C
235G,235G,15,859,911,52,90,10,1,C
235G,235G,15,919,945,26,90,10,1,C
235G,235G,15,998,1019,21,90,10,1,C
235G,235G,15,1025,1054,29,90,10,1,C
235G,235G,15,1099,1122,23,90,10,1,C
235G,235G,15,1143,1153,10,90,10,1,C
235G,235G,15,1198,1210,12,90,10,1,C
235G,235G,15,1299,1309,10,90,10,1,C
235G,235G,15,1336,1348,12,90,10,1,C
235G,235G,15,1353,1366,13,90,10,1,C
235G,235G,15,1375,1392,17,90,10,1,C
235G,235G,15,1398,1417,19,90,10,1,C
235G,235G,15,1429,1449,20,90,10,1,C
235G,235G,15,1457,1487,30,90,10,1,C
235G,235G,15,1504,1517,13,90,10,1,C
235G,235G,15,1531,1554,23,90,10,1,C
235G,235G,15,1584,1595,11,90,10,1,C
235G,235G,15,1660,1670,10,90,10,1,C
235G,235G,15,1675,1691,16,90,10,1,C
235G,235G,15,1697,1712,15,90,10,1,C
235G,235G,15,1717,1749,32,90,10,1,C
235G,235G,15,1762,1783,21,90,10,1,C
235G,235G,15,1832,1868,36,90,10,1,C
235G,235G,15,1960,2011,51,90,10,1,C
235G,235G,15,2033,2049,16,90,10,1,C
235G,235G,15,2054,2075,21,90,10,1,C
235G,235G,15,2117,2143,26,90,10,1,C
235G,235G,15,2154,2166,12,90,10,1,C
235G,235G,15,2212,2255,43,90,10,1,C
235G,235G,15,2293,2321,28,90,10,1,C
235G,235G,15,2330,2357,27,90,10,1,C
235G,235G,15,2401,2416,15,90,10,1,C
235G,235G,15,2422,2435,13,90,10,1,C
235G,235G,15,2448,2486,38,90,10,1,C
235G,235G,15,2742,2762,20,90,10,1,C
235G,235G,15,2770,2799,29,90,10,1,C
235G,235G,15,2810,2825,15,90,10,1,C
235G,235G,15,2871,2893,22,90,10,1,C
235G,235G,15,2908,2927,19,90,10,1,C
235G,235G,15,2956,2990,34,90,10,1,C
235G,235G,28,0,18,18,90,10,1,C
235G,235G,28,87,103,16,90,10,1,C
235G,235G,28,122,154,32,90,10,1,C
235G,235G,28,307,320,13,90,10,1,C
235G,235G,28,364,388,24,90,10,1,C
235G,235G,28,404,417,13,90,10,1,C
235G,235G,28,435,462,27,90,10,1,C
235G,235G,28,489,553,64,90,10,1,C
235G,235G,28,804,824,20,90,10,1,C
235G,235G,28,830,843,13,90,10,1,C
235G,235G,28,865,923,58,90,10,1,C
235G,235G,28,937,955,18,90,10,1,C
235G,235G,28,1053,1087,34,90,10,1,C
235G,235G,28,1095,1125,30,90,10,1,C
235G,235G,28,1251,1265,14,90,10,1,C
235G,235G,28,1275,1292,17,90,10,1,C
235G,235G,28,1313,1326,13,90,10,1,C
235G,235G,28,1359,1373,14,90,10,1,C
235G,235G,28,1400,1444,44,90,10,1,C
235G,235G,28,1488,1501,13,90,10,1,C
235G,235G,28,1551,1567,16,90,10,1,C
235G,235G,28,1645,1666,21,90,10,1,C
235G,235G,28,1683,1702,19,90,10,1,C
235G,235G,28,1709,1720,11,90,10,1,C
235G,235G,28,1743,1758,15,90,10,1,C
235G,235G,28,1782,1799,17,90,10,1,C
235G,235G,28,1833,1847,14,90,10,1,C
235G,235G,28,1866,1882,16,90,10,1,C
235G,235G,28,1970,1986,16,90,10,1,C
235G,235G,28,2098,2125,27,90,10,1,C
235G,235G,28,2160,2182,22,90,10,1,C
235G,235G,28,2215,2244,29,90,10,1,C
235G,235G,28,2312,2343,31,90,10,1,C
235G,235G,28,2415,2433,18,90,10,1,C
235G,235G,28,2442,2463,21,90,10,1,C
235G,235G,28,2469,2494,25,90,10,1,C
235G,235G,28,2500,2510,10,90,10,1,C
235G,235G,28,2533,2570,37,90,10,1,C
235G,235G,28,2591,2607,16,90,10,1,C
235G,235G,28,2625,2646,21,90,10,1,C
235G,235G,28,2653,2668,15,90,10,1,C
235G,235G,28,2705,2720,15,90,10,1,C
235G,235G,28,2752,2770,18,90,10,1,C
235G,235G,28,2823,2855,32,90,10,1,C
235G,235G,28,2869,2902,33,90,10,1,C
235G,235G,28,2920,2933,13,90,10,1,C
235G,235G,28,2946,2981,35,90,10,1,C
235G,235G,28,2990,3000,10,90,10,1,C
236A,236A,2,432,447,15,90,10,1,C
236A,236A,2,540,563,23,90,10,1,C
236A,236A,2,730,754,24,90,10,1,C
236A,236A,2,953,970,17,90,10,1,C
236A,236A,2,993,1014,21,90,10,1,C
236A,236A,2,1100,1119,19,90,10,1,C
236A,236A,2,1145,1161,16,90,10,1,C
236A,236A,2,1233,1250,17,90,10,1,C
236A,236A,2,1719,1736,17,90,10,1,C
236A,236A,2,1778,1791,13,90,10,1,C
236A,236A,2,1980,1990,10,90,10,1,C
236A,236A,2,2078,2104,26,90,10,1,C
236A,236A,2,2294,2320,26,90,10,1,C
236A,236A,2,2402,2422,20,90,10,1,C
236A,236A,2,2512,2535,23,90,10,1,C
236A,236A,2,2909,2921,12,90,10,1,C
236A,236A,2,2959,2985,26,90,10,1,C
236A,236A,15,49,62,13,90,10,1,C
236A,236A,15,229,241,12,90,10,1,C
236A,236A,15,256,271,15,90,10,1,C
236A,236A,15,329,340,11,90,10,1,C
236A,236A,15,451,464,13,90,10,1,C
236A,236A,15,607,623,16,90,10,1,C
236A,236A,15,693,704,11,90,10,1,C
236A,236A,15,935,946,11,90,10,1,C
236A,236A,15,971,982,11,90,10,1,C
236A,236A,15,999,1011,12,90,10,1,C
236A,236A,15,1135,1161,26,90,10,1,C
236A,236A,15,1172,1182,10,90,10,1,C
236A,236A,15,1226,1248,22,90,10,1,C
236A,236A,15,1278,1305,27,90,10,1,C
236A,236A,15,1392,1410,18,90,10,1,C
236A,236A,15,1462,1476,14,90,10,1,C
236A,236A,15,1638,1654,16,90,10,1,C
236A,236A,15,1729,1741,12,90,10,1,C
236A,236A,15,1962,1977,15,90,10,1,C
236A,236A,15,2052,2077,25,90,10,1,C
236A,236A,15,2338,2351,13,90,10,1,C
236A,236A,15,2401,2414,13,90,10,1,C
236A,236A,15,2473,2489,16,90,10,1,C
236A,236A,15,2629,2642,13,90,10,1,C
236A,236A,15,2800,2810,10,90,10,1,C
236A,236A,15,2935,2949,14,90,10,1,C
236A,236A,15,2988,3000,12,90,10,1,C
236A,236A,28,13,25,12,90,10,1,C
236A,236A,28,108,119,11,90,10,1,C
236A,236A,28,178,189,11,90,10,1,C
236A,236A,28,195,211,16,90,10,1,C
236A,236A,28,239,249,10,90,10,1,C
236A,236A,28,273,287,14,90,10,1,C
236A,236A,28,350,366,16,90,10,1,C
236A,236A,28,509,523,14,90,10,1,C
236A,236A,28,590,603,13,90,10,1,C
236A,236A,28,652,668,16,90,10,1,C
236A,236A,28,688,703,15,90,10,1,C
236A,236A,28,749,767,18,90,10,1,C
236A,236A,28,772,784,12,90,10,1,C
236A,236A,28,831,858,27,90,10,1,C
236A,236A,28,880,897,17,90,10,1,C
236A,236A,28,995,1026,31,90,10,1,C
236A,236A,28,1060,1073,13,90,10,1,C
236A,236A,28,1093,1109,16,90,10,1,C
236A,236A,28,1544,1559,15,90,10,1,C
236A,236A,28,1611,1623,12,90,10,1,C
236A,236A,28,1668,1686,18,90,10,1,C
236A,236A,28,1713,1730,17,90,10,1,C
236A,236A,28,1801,1846,45,90,10,1,C
236A,236A,28,1976,1995,19,90,10,1,C
236A,236A,28,2306,2317,11,90,10,1,C
236A,236A,28,2452,2462,10,90,10,1,C
236A,236A,28,2815,2855,40,90,10,1,C
236G,236G,2,0,19,19,90,10,1,C
236G,236G,2,59,73,14,90,10,1,C
236G,236G,2,83,127,44,90,10,1,C
236G,236G,2,132,160,28,90,10,1,C
236G,236G,2,162,175,13,90,10,1,C
236G,236G,2,220,231,11,90,10,1,C
236G,236G,2,270,308,38,90,10,1,C
236G,236G,2,319,340,21,90,10,1,C
236G,236G,2,358,382,24,90,10,1,C
236G,236G,2,386,427,41,90,10,1,C
236G,236G,2,432,460,28,90,10,1,C
236G,236G,2,476,510,34,90,10,1,C
236G,236G,2,529,561,32,90,10,1,C
236G,236G,2,589,621,32,90,10,1,C
236G,236G,2,631,749,118,90,10,1,C
236G,236G,2,882,910,28,90,10,1,C
236G,236G,2,1034,1057,23,90,10,1,C
236G,236G,2,1076,1097,21,90,10,1,C
236G,236G,2,1132,1150,18,90,10,1,C
236G,236G,2,1156,1178,22,90,10,1,C
236G,236G,2,1243,1306,63,90,10,1,C
236G,236G,2,1324,1350,26,90,10,1,C
236G,236G,2,1782,1823,41,90,10,1,C
236G,236G,2,1929,2020,91,90,10,1,C
236G,236G,2,2086,2111,25,90,10,1,C
236G,236G,2,2128,2139,11,90,10,1,C
236G,236G,2,2172,2196,24,90,10,1,C
236G,236G,2,2234,2267,33,90,10,1,C
236G,236G,2,2321,2337,16,90,10,1,C
236G,236G,2,2375,2406,31,90,10,1,C
236G,236G,2,2411,2422,11,90,10,1,C
236G,236G,2,2449,2496,47,90,10,1,C
236G,236G,2,2502,2519,17,90,10,1,C
236G,236G,2,2536,2554,18,90,10,1,C
236G,236G,2,2569,2586,17,90,10,1,C
236G,236G,2,2650,2677,27,90,10,1,C
236G,236G,2,2682,2698,16,90,10,1,C
236G,236G,2,2765,2811,46,90,10,1,C
236G,236G,2,2816,2832,16,90,10,1,C
236G,236G,2,2871,2891,20,90,10,1,C
236G,236G,2,2902,2918,16,90,10,1,C
236G,236G,2,2933,2982,49,90,10,1,C
236G,236G,15,88,110,22,90,10,1,C
236G,236G,15,160,172,12,90,10,1,C
236G,236G,15,315,334,19,90,10,1,C
236G,236G,15,344,358,14,90,10,1,C
236G,236G,15,370,380,10,90,10,1,C
236G,236G,15,432,443,11,90,10,1,C
236G,236G,15,449,492,43,90,10,1,C
236G,236G,15,497,509,12,90,10,1,C
236G,236G,15,524,537,13,90,10,1,C
236G,236G,15,542,572,30,90,10,1,C
236G,236G,15,603,632,29,90,10,1,C
236G,236G,15,639,655,16,90,10,1,C
236G,236G,15,674,705,31,90,10,1,C
236G,236G,15,743,760,17,90,10,1,C
236G,236G,15,776,817,41,90,10,1,C
236G,236G,15,829,873,44,90,10,1,C
236G,236G,15,883,895,12,90,10,1,C
236G,236G,15,900,910,10,90,10,1,C
236G,236G,15,931,959,28,90,10,1,C
236G,236G,15,992,1014,22,90,10,1,C
236G,236G,15,1026,1045,19,90,10,1,C
236G,236G,15,1100,1115,15,90,10,1,C
236G,236G,15,1123,1174,51,90,10,1,C
236G,236G,15,1185,1219,34,90,10,1,C
236G,236G,15,1267,1291,24,90,10,1,C
236G,236G,15,1299,1320,21,90,10,1,C
236G,236G,15,1406,1433,27,90,10,1,C
236G,236G,15,1474,1495,21,90,10,1,C
236G,236G,15,1510,1527,17,90,10,1,C
236G,236G,15,1563,1601,38,90,10,1,C
236G,236G,15,1615,1647,32,90,10,1,C
236G,236G,15,1655,1673,18,90,10,1,C
236G,236G,15,1782,1800,18,90,10,1,C
236G,236G,15,1850,1865,15,90,10,1,C
236G,236G,15,1913,1926,13,90,10,1,C
236G,236G,15,1960,1981,21,90,10,1,C
236G,236G,15,2050,2066,16,90,10,1,C
236G,236G,15,2143,2177,34,90,10,1,C
236G,236G,15,2190,2216,26,90,10,1,C
236G,236G,15,2221,2240,19,90,10,1,C
236G,236G,15,2272,2287,15,90,10,1,C
236G,236G,15,2385,2408,23,90,10,1,C
236G,236G,15,2426,2444,18,90,10,1,C
236G,236G,15,2449,2462,13,90,10,1,C
236G,236G,15,2526,2550,24,90,10,1,C
236G,236G,15,2640,2659,19,90,10,1,C
236G,236G,15,2698,2717,19,90,10,1,C
236G,236G,15,2735,2754,19,90,10,1,C
236G,236G,15,2760,2774,14,90,10,1,C
236G,236G,15,2797,2824,27,90,10,1,C
236G,236G,15,2942,2958,16,90,10,1,C
236G,236G,28,2,12,10,90,10,1,C
236G,236G,28,16,26,10,90,10,1,C
236G,236G,28,31,42,11,90,10,1,C
236G,236G,28,51,77,26,90,10,1,C
236G,236G,28,80,92,12,90,10,1,C
236G,236G,28,182,197,15,90,10,1,C
236G,236G,28,203,216,13,90,10,1,C
236G,236G,28,222,242,20,90,10,1,C
236G,236G,28,249,270,21,90,10,1,C
236G,236G,28,280,296,16,90,10,1,C
236G,236G,28,318,343,25,90,10,1,C
236G,236G,28,393,406,13,90,10,1,C
236G,236G,28,408,420,12,90,10,1,C
236G,236G,28,431,455,24,90,10,1,C
236G,236G,28,491,506,15,90,10,1,C
236G,236G,28,524,537,13,90,10,1,C
236G,236G,28,542,555,13,90,10,1,C
236G,236G,28,579,602,23,90,10,1,C
236G,236G,28,676,692,16,90,10,1,C
236G,236G,28,726,763,37,90,10,1,C
236G,236G,28,787,821,34,90,10,1,C
236G,236G,28,860,901,41,90,10,1,C
236G,236G,28,917,940,23,90,10,1,C
236G,236G,28,947,957,10,90,10,1,C
236G,236G,28,979,1020,41,90,10,1,C
236G,236G,28,1024,1042,18,90,10,1,C
236G,236G,28,1061,1082,21,90,10,1,C
236G,236G,28,1085,1098,13,90,10,1,C
236G,236G,28,1101,1118,17,90,10,1,C
236G,236G,28,1121,1193,72,90,10,1,C
236G,236G,28,1210,1245,35,90,10,1,C
236G,236G,28,1254,1279,25,90,10,1,C
236G,236G,28,1291,1302,11,90,10,1,C
236G,236G,28,1306,1344,38,90,10,1,C
236G,236G,28,1371,1392,21,90,10,1,C
236G,236G,28,1399,1416,17,90,10,1,C
236G,236G,28,1421,1447,26,90,10,1,C
236G,236G,28,1452,1472,20,90,10,1,C
236G,236G,28,1476,1501,25,90,10,1,C
236G,236G,28,1521,1537,16,90,10,1,C
236G,236G,28,1540,1572,32,90,10,1,C
236G,236G,28,1608,1622,14,90,10,1,C
236G,236G,28,1650,1661,11,90,10,1,C
236G,236G,28,1663,1677,14,90,10,1,C
236G,236G,28,1692,1702,10,90,10,1,C
236G,236G,28,1705,1715,10,90,10,1,C
236G,236G,28,1724,1751,27,90,10,1,C
236G,236G,28,1779,1801,22,90,10,1,C
236G,236G,28,1821,1836,15,90,10,1,C
236G,236G,28,1841,1875,34,90,10,1,C
236G,236G,28,1891,1922,31,90,10,1,C
236G,236G,28,1932,1954,22,90,10,1,C
236G,236G,28,1965,1977,12,90,10,1,C
236G,236G,28,1980,2001,21,90,10,1,C
236G,236G,28,2053,2096,43,90,10,1,C
236G,236G,28,2129,2145,16,90,10,1,C
236G,236G,28,2170,2208,38,90,10,1,C
236G,236G,28,2227,2240,13,90,10,1,C
236G,236G,28,2264,2283,19,90,10,1,C
236G,236G,28,2287,2308,21,90,10,1,C
236G,236G,28,2382,2405,23,90,10,1,C
236G,236G,28,2410,2440,30,90,10,1,C
236G,236G,28,2458,2477,19,90,10,1,C
236G,236G,28,2648,2660,12,90,10,1,C
236G,236G,28,2664,2676,12,90,10,1,C
236G,236G,28,2689,2700,11,90,10,1,C
236G,236G,28,2722,2735,13,90,10,1,C
236G,236G,28,2780,2801,21,90,10,1,C
236G,236G,28,2854,2882,28,90,10,1,C
236G,236G,28,2903,2914,11,90,10,1,C
236G,236G,28,2930,2942,12,90,10,1,C
236G,236G,28,2969,2985,16,90,10,1,C
237A,237A,2,0,58,58,90,10,1,C
237A,237A,2,76,97,21,90,10,1,C
237A,237A,2,187,242,55,90,10,1,C
237A,237A,2,290,322,32,90,10,1,C
237A,237A,2,380,392,12,90,10,1,C
237A,237A,2,405,464,59,90,10,1,C
237A,237A,2,561,591,30,90,10,1,C
237A,237A,2,625,651,26,90,10,1,C
237A,237A,2,682,700,18,90,10,1,C
237A,237A,2,706,718,12,90,10,1,C
237A,237A,2,746,767,21,90,10,1,C
237A,237A,2,771,801,30,90,10,1,C
237A,237A,2,831,857,26,90,10,1,C
237A,237A,2,911,930,19,90,10,1,C
237A,237A,2,971,1021,50,90,10,1,C
237A,237A,2,1049,1068,19,90,10,1,C
237A,237A,2,1093,1114,21,90,10,1,C
237A,237A,2,1160,1187,27,90,10,1,C
237A,237A,2,1216,1238,22,90,10,1,C
237A,237A,2,1288,1309,21,90,10,1,C
237A,237A,2,1334,1375,41,90,10,1,C
237A,237A,2,1393,1437,44,90,10,1,C
237A,237A,2,1465,1492,27,90,10,1,C
237A,237A,2,1559,1576,17,90,10,1,C
237A,237A,2,1665,1751,86,90,10,1,C
237A,237A,2,1794,1840,46,90,10,1,C
237A,237A,2,1851,1877,26,90,10,1,C
237A,237A,2,1919,1932,13,90,10,1,C
237A,237A,2,1937,1972,35,90,10,1,C
237A,237A,2,1994,2009,15,90,10,1,C
237A,237A,2,2018,2037,19,90,10,1,C
237A,237A,2,2049,2079,30,90,10,1,C
237A,237A,2,2084,2094,10,90,10,1,C
237A,237A,2,2141,2164,23,90,10,1,C
237A,237A,2,2168,2183,15,90,10,1,C
237A,237A,2,2243,2256,13,90,10,1,C
237A,237A,2,2262,2289,27,90,10,1,C
237A,237A,2,2295,2309,14,90,10,1,C
237A,237A,2,2319,2334,15,90,10,1,C
237A,237A,2,2342,2390,48,90,10,1,C
237A,237A,2,2456,2486,30,90,10,1,C
237A,237A,2,2504,2526,22,90,10,1,C
237A,237A,2,2537,2570,33,90,10,1,C
237A,237A,2,2581,2600,19,90,10,1,C
237A,237A,2,2611,2631,20,90,10,1,C
237A,237A,2,2641,2698,57,90,10,1,C
237A,237A,2,2700,2722,22,90,10,1,C
237A,237A,2,2774,2792,18,90,10,1,C
237A,237A,2,2802,2823,21,90,10,1,C
237A,237A,2,2827,2842,15,90,10,1,C
237A,237A,2,2865,2877,12,90,10,1,C
237A,237A,15,51,63,12,90,10,1,C
237A,237A,15,117,128,11,90,10,1,C
237A,237A,15,609,622,13,90,10,1,C
237A,237A,15,670,694,24,90,10,1,C
237A,237A,15,784,794,10,90,10,1,C
237A,237A,15,835,847,12,90,10,1,C
237A,237A,15,883,905,22,90,10,1,C
237A,237A,15,916,934,18,90,10,1,C
237A,237A,15,948,977,29,90,10,1,C
237A,237A,15,997,1022,25,90,10,1,C
237A,237A,15,1046,1058,12,90,10,1,C
237A,237A,15,1071,1085,14,90,10,1,C
237A,237A,15,1184,1199,15,90,10,1,C
237A,237A,15,1304,1318,14,90,10,1,C
237A,237A,15,1331,1368,37,90,10,1,C
237A,237A,15,1387,1409,22,90,10,1,C
237A,237A,15,1614,1633,19,90,10,1,C
237A,237A,15,1972,1990,18,90,10,1,C
237A,237A,15,2010,2027,17,90,10,1,C
237A,237A,15,2077,2090,13,90,10,1,C
237A,237A,15,2184,2210,26,90,10,1,C
237A,237A,15,2219,2256,37,90,10,1,C
237A,237A,15,2261,2282,21,90,10,1,C
237A,237A,15,2332,2357,25,90,10,1,C
237A,237A,15,2368,2427,59,90,10,1,C
237A,237A,15,2441,2460,19,90,10,1,C
237A,237A,15,2493,2504,11,90,10,1,C
237A,237A,15,2514,2530,16,90,10,1,C
237A,237A,15,2570,2588,18,90,10,1,C
237A,237A,15,2672,2687,15,90,10,1,C
237A,237A,15,2941,2962,21,90,10,1,C
237A,237A,15,2974,2987,13,90,10,1,C
237A,237A,28,9,27,18,90,10,1,C
237A,237A,28,126,152,26,90,10,1,C
237A,237A,28,182,200,18,90,10,1,C
237A,237A,28,210,225,15,90,10,1,C
237A,237A,28,232,246,14,90,10,1,C
237A,237A,28,251,267,16,90,10,1,C
237A,237A,28,284,300,16,90,10,1,C
237A,237A,28,305,316,11,90,10,1,C
237A,237A,28,350,361,11,90,10,1,C
237A,237A,28,372,391,19,90,10,1,C
237A,237A,28,397,418,21,90,10,1,C
237A,237A,28,432,449,17,90,10,1,C
237A,237A,28,455,465,10,90,10,1,C
237A,237A,28,472,491,19,90,10,1,C
237A,237A,28,495,509,14,90,10,1,C
237A,237A,28,541,554,13,90,10,1,C
237A,237A,28,564,596,32,90,10,1,C
237A,237A,28,621,637,16,90,10,1,C
237A,237A,28,711,734,23,90,10,1,C
237A,237A,28,784,804,20,90,10,1,C
237A,237A,28,807,829,22,90,10,1,C
237A,237A,28,896,907,11,90,10,1,C
237A,237A,28,911,923,12,90,10,1,C
237A,237A,28,928,943,15,90,10,1,C
237A,237A,28,949,979,30,90,10,1,C
237A,237A,28,984,995,11,90,10,1,C
237A,237A,28,1040,1094,54,90,10,1,C
237A,237A,28,1107,1150,43,90,10,1,C
237A,237A,28,1174,1198,24,90,10,1,C
237A,237A,28,1245,1321,76,90,10,1,C
237A,237A,28,1342,1359,17,90,10,1,C
237A,237A,28,1400,1419,19,90,10,1,C
237A,237A,28,1424,1502,78,90,10,1,C
237A,237A,28,1520,1542,22,90,10,1,C
237A,237A,28,1564,1592,28,90,10,1,C
237A,237A,28,1612,1634,22,90,10,1,C
237A,237A,28,1649,1688,39,90,10,1,C
237A,237A,28,1726,1742,16,90,10,1,C
237A,237A,28,1761,1779,18,90,10,1,C
237A,237A,28,1784,1814,30,90,10,1,C
237A,237A,28,2002,2017,15,90,10,1,C
237A,237A,28,2094,2117,23,90,10,1,C
237A,237A,28,2243,2260,17,90,10,1,C
237A,237A,28,2297,2311,14,90,10,1,C
237A,237A,28,2325,2345,20,90,10,1,C
237A,237A,28,2350,2363,13,90,10,1,C
237A,237A,28,2396,2412,16,90,10,1,C
237A,237A,28,2420,2446,26,90,10,1,C
237A,237A,28,2473,2492,19,90,10,1,C
237A,237A,28,2532,2542,10,90,10,1,C
237A,237A,28,2547,2559,12,90,10,1,C
237A,237A,28,2781,2792,11,90,10,1,C
237A,237A,28,2801,2819,18,90,10,1,C
237A,237A,28,2831,2842,11,90,10,1,C
237A,237A,28,2851,2863,12,90,10,1,C
237A,237A,28,2943,2964,21,90,10,1,C
237A,237A,28,2980,2991,11,90,10,1,C
237G,237G,2,99,122,23,90,10,1,C
237G,237G,2,127,150,23,90,10,1,C
237G,237G,2,170,180,10,90,10,1,C
237G,237G,2,189,202,13,90,10,1,C
237G,237G,2,209,224,15,90,10,1,C
237G,237G,2,280,290,10,90,10,1,C
237G,237G,2,363,390,27,90,10,1,C
237G,237G,2,408,435,27,90,10,1,C
237G,237G,2,465,482,17,90,10,1,C
237G,237G,2,527,543,16,90,10,1,C
237G,237G,2,560,573,13,90,10,1,C
237G,237G,2,602,617,15,90,10,1,C
237G,237G,2,622,659,37,90,10,1,C
237G,237G,2,694,711,17,90,10,1,C
237G,237G,2,725,735,10,90,10,1,C
237G,237G,2,746,790,44,90,10,1,C
237G,237G,2,822,849,27,90,10,1,C
237G,237G,2,855,867,12,90,10,1,C
237G,237G,2,902,922,20,90,10,1,C
237G,237G,2,927,934,7,90,10,1,C
237G,237G,2,948,994,46,90,10,1,C
237G,237G,2,1020,1039,19,90,10,1,C
237G,237G,2,1065,1083,18,90,10,1,C
237G,237G,2,1110,1128,18,90,10,1,C
237G,237G,2,1133,1143,10,90,10,1,C
237G,237G,2,1165,1184,19,90,10,1,C
237G,237G,2,1211,1228,17,90,10,1,C
237G,237G,2,1245,1259,14,90,10,1,C
237G,237G,2,1268,1290,22,90,10,1,C
237G,237G,2,1295,1331,36,90,10,1,C
237G,237G,2,1340,1355,15,90,10,1,C
237G,237G,2,1360,1374,14,90,10,1,C
237G,237G,2,1390,1407,17,90,10,1,C
237G,237G,2,1426,1437,11,90,10,1,C
237G,237G,2,1455,1485,30,90,10,1,C
237G,237G,2,1533,1575,42,90,10,1,C
237G,237G,2,1598,1621,23,90,10,1,C
237G,237G,2,1626,1657,31,90,10,1,C
237G,237G,2,1664,1698,34,90,10,1,C
237G,237G,2,1710,1733,23,90,10,1,C
237G,237G,2,1770,2033,263,90,10,1,C
237G,237G,2,2038,2076,38,90,10,1,C
237G,237G,2,2085,2101,16,90,10,1,C
237G,237G,2,2130,2148,18,90,10,1,C
237G,237G,2,2164,2183,19,90,10,1,C
237G,237G,2,2198,2213,15,90,10,1,C
237G,237G,2,2218,2242,24,90,10,1,C
237G,237G,2,2292,2302,10,90,10,1,C
237G,237G,2,2435,2459,24,90,10,1,C
237G,237G,2,2519,2538,19,90,10,1,C
237G,237G,2,2573,2590,17,90,10,1,C
237G,237G,2,2608,2620,12,90,10,1,C
237G,237G,2,2775,2811,36,90,10,1,C
237G,237G,2,2912,2928,16,90,10,1,C
237G,237G,2,2956,2976,20,90,10,1,C
237G,237G,15,61,77,16,90,10,1,C
237G,237G,15,92,108,16,90,10,1,C
237G,237G,15,113,126,13,90,10,1,C
237G,237G,15,142,167,25,90,10,1,C
237G,237G,15,201,230,29,90,10,1,C
237G,237G,15,242,263,21,90,10,1,C
237G,237G,15,296,308,12,90,10,1,C
237G,237G,15,311,322,11,90,10,1,C
237G,237G,15,349,360,11,90,10,1,C
237G,237G,15,371,382,11,90,10,1,C
237G,237G,15,446,460,14,90,10,1,C
237G,237G,15,479,491,12,90,10,1,C
237G,237G,15,590,602,12,90,10,1,C
237G,237G,15,613,629,16,90,10,1,C
237G,237G,15,649,671,22,90,10,1,C
237G,237G,15,865,892,27,90,10,1,C
237G,237G,15,996,1013,17,90,10,1,C
237G,237G,15,1055,1071,16,90,10,1,C
237G,237G,15,1085,1099,14,90,10,1,C
237G,237G,15,1111,1129,18,90,10,1,C
237G,237G,15,1137,1180,43,90,10,1,C
237G,237G,15,1206,1220,14,90,10,1,C
237G,237G,15,1242,1259,17,90,10,1,C
237G,237G,15,1292,1302,10,90,10,1,C
237G,237G,15,1349,1362,13,90,10,1,C
237G,237G,15,1419,1440,21,90,10,1,C
237G,237G,15,1492,1507,15,90,10,1,C
237G,237G,15,1592,1611,19,90,10,1,C
237G,237G,15,1620,1639,19,90,10,1,C
237G,237G,15,1655,1674,19,90,10,1,C
237G,237G,15,1711,1746,35,90,10,1,C
237G,237G,15,1876,1892,16,90,10,1,C
237G,237G,15,1901,1924,23,90,10,1,C
237G,237G,15,1950,1961,11,90,10,1,C
237G,237G,15,2008,2034,26,90,10,1,C
237G,237G,15,2042,2053,11,90,10,1,C
237G,237G,15,2091,2128,37,90,10,1,C
237G,237G,15,2134,2163,29,90,10,1,C
237G,237G,15,2189,2210,21,90,10,1,C
237G,237G,15,2241,2265,24,90,10,1,C
237G,237G,15,2321,2343,22,90,10,1,C
237G,237G,15,2378,2411,33,90,10,1,C
237G,237G,15,2417,2436,19,90,10,1,C
237G,237G,15,2462,2476,14,90,10,1,C
237G,237G,15,2518,2534,16,90,10,1,C
237G,237G,15,2542,2558,16,90,10,1,C
237G,237G,15,2712,2736,24,90,10,1,C
237G,237G,15,2811,2838,27,90,10,1,C
237G,237G,28,70,109,39,90,10,1,C
237G,237G,28,163,176,13,90,10,1,C
237G,237G,28,207,220,13,90,10,1,C
237G,237G,28,240,259,19,90,10,1,C
237G,237G,28,291,303,12,90,10,1,C
237G,237G,28,333,351,18,90,10,1,C
237G,237G,28,364,377,13,90,10,1,C
237G,237G,28,382,402,20,90,10,1,C
237G,237G,28,407,421,14,90,10,1,C
237G,237G,28,443,541,98,90,10,1,C
237G,237G,28,565,583,18,90,10,1,C
237G,237G,28,600,621,21,90,10,1,C
237G,237G,28,644,660,16,90,10,1,C
237G,237G,28,685,705,20,90,10,1,C
237G,237G,28,710,724,14,90,10,1,C
237G,237G,28,755,768,13,90,10,1,C
237G,237G,28,959,982,23,90,10,1,C
237G,237G,28,1179,1198,19,90,10,1,C
237G,237G,28,1221,1234,13,90,10,1,C
237G,237G,28,1272,1300,28,90,10,1,C
237G,237G,28,1311,1335,24,90,10,1,C
237G,237G,28,1375,1519,144,90,10,1,C
237G,237G,28,1552,1612,60,90,10,1,C
237G,237G,28,1619,1637,18,90,10,1,C
237G,237G,28,1643,1662,19,90,10,1,C
237G,237G,28,1740,1788,48,90,10,1,C
237G,237G,28,1839,1850,11,90,10,1,C
237G,237G,28,1867,1888,21,90,10,1,C
237G,237G,28,1926,1954,28,90,10,1,C
237G,237G,28,2047,2068,21,90,10,1,C
237G,237G,28,2073,2096,23,90,10,1,C
237G,237G,28,2132,2153,21,90,10,1,C
237G,237G,28,2181,2189,8,90,10,1,C
237G,237G,28,2231,2252,21,90,10,1,C
237G,237G,28,2261,2274,13,90,10,1,C
237G,237G,28,2304,2337,33,90,10,1,C
237G,237G,28,2420,2433,13,90,10,1,C
237G,237G,28,2482,2501,19,90,10,1,C
237G,237G,28,2515,2545,30,90,10,1,C
237G,237G,28,2566,2580,14,90,10,1,C
237G,237G,28,2631,2660,29,90,10,1,C
237G,237G,28,2701,2713,12,90,10,1,C
237G,237G,28,2866,2884,18,90,10,1,C
238A,238A,2,11,41,30,90,10,1,C
238A,238A,2,95,210,115,90,10,1,C
238A,238A,2,302,318,16,90,10,1,C
238A,238A,2,404,442,38,90,10,1,C
238A,238A,2,503,516,13,90,10,1,C
238A,238A,2,574,606,32,90,10,1,C
238A,238A,2,621,638,17,90,10,1,C
238A,238A,2,675,707,32,90,10,1,C
238A,238A,2,730,774,44,90,10,1,C
238A,238A,2,863,878,15,90,10,1,C
238A,238A,2,983,1012,29,90,10,1,C
238A,238A,2,1033,1062,29,90,10,1,C
238A,238A,2,1146,1161,15,90,10,1,C
238A,238A,2,1219,1252,33,90,10,1,C
238A,238A,2,1325,1359,34,90,10,1,C
238A,238A,2,1395,1433,38,90,10,1,C
238A,238A,2,1609,1627,18,90,10,1,C
238A,238A,2,1694,1720,26,90,10,1,C
238A,238A,2,2020,2054,34,90,10,1,C
238A,238A,2,2104,2125,21,90,10,1,C
238A,238A,2,2150,2161,11,90,10,1,C
238A,238A,2,2345,2356,11,90,10,1,C
238A,238A,2,2368,2386,18,90,10,1,C
238A,238A,2,2447,2472,25,90,10,1,C
238A,238A,2,2502,2525,23,90,10,1,C
238A,238A,2,2606,2627,21,90,10,1,C
238A,238A,2,2833,2850,17,90,10,1,C
238A,238A,2,2921,2949,28,90,10,1,C
238A,238A,15,23,46,23,90,10,1,C
238A,238A,15,94,105,11,90,10,1,C
238A,238A,15,148,173,25,90,10,1,C
238A,238A,15,240,260,20,90,10,1,C
238A,238A,15,291,311,20,90,10,1,C
238A,238A,15,340,371,31,90,10,1,C
238A,238A,15,505,519,14,90,10,1,C
238A,238A,15,594,618,24,90,10,1,C
238A,238A,15,677,700,23,90,10,1,C
238A,238A,15,799,813,14,90,10,1,C
238A,238A,15,932,956,24,90,10,1,C
238A,238A,15,1015,1051,36,90,10,1,C
238A,238A,15,1343,1359,16,90,10,1,C
238A,238A,15,1673,1687,14,90,10,1,C
238A,238A,15,1754,1766,12,90,10,1,C
238A,238A,15,1826,1864,38,90,10,1,C
238A,238A,15,1951,1964,13,90,10,1,C
238A,238A,15,2070,2091,21,90,10,1,C
238A,238A,15,2184,2197,13,90,10,1,C
238A,238A,15,2242,2265,23,90,10,1,C
238A,238A,15,2325,2341,16,90,10,1,C
238A,238A,15,2410,2427,17,90,10,1,C
238A,238A,15,2492,2507,15,90,10,1,C
238A,238A,15,2666,2683,17,90,10,1,C
238A,238A,15,2832,2853,21,90,10,1,C
238A,238A,15,2920,2937,17,90,10,1,C
238A,238A,28,0,15,15,90,10,1,C
238A,238A,28,63,75,12,90,10,1,C
238A,238A,28,90,112,22,90,10,1,C
238A,238A,28,125,138,13,90,10,1,C
238A,238A,28,168,182,14,90,10,1,C
238A,238A,28,214,231,17,90,10,1,C
238A,238A,28,275,286,11,90,10,1,C
238A,238A,28,310,323,13,90,10,1,C
238A,238A,28,332,345,13,90,10,1,C
238A,238A,28,405,415,10,90,10,1,C
238A,238A,28,481,533,52,90,10,1,C
238A,238A,28,584,601,17,90,10,1,C
238A,238A,28,694,711,17,90,10,1,C
238A,238A,28,778,800,22,90,10,1,C
238A,238A,28,806,830,24,90,10,1,C
238A,238A,28,894,934,40,90,10,1,C
238A,238A,28,1004,1014,10,90,10,1,C
238A,238A,28,1059,1070,11,90,10,1,C
238A,238A,28,1182,1300,118,90,10,1,C
238A,238A,28,1374,1385,11,90,10,1,C
238A,238A,28,1395,1411,16,90,10,1,C
238A,238A,28,1450,1507,57,90,10,1,C
238A,238A,28,1556,1573,17,90,10,1,C
238A,238A,28,1585,1630,45,90,10,1,C
238A,238A,28,1673,1689,16,90,10,1,C
238A,238A,28,1774,1795,21,90,10,1,C
238A,238A,28,1821,1835,14,90,10,1,C
238A,238A,28,1970,1983,13,90,10,1,C
238A,238A,28,2155,2175,20,90,10,1,C
238A,238A,28,2291,2317,26,90,10,1,C
238A,238A,28,2422,2440,18,90,10,1,C
238A,238A,28,2712,2726,14,90,10,1,C
238A,238A,28,2847,2861,14,90,10,1,C
238G,238G,2,19,38,19,90,10,1,C
238G,238G,2,65,80,15,90,10,1,C
238G,238G,2,140,194,54,90,10,1,C
238G,238G,2,215,248,33,90,10,1,C
238G,238G,2,299,350,51,90,10,1,C
238G,238G,2,362,415,53,90,10,1,C
238G,238G,2,453,480,27,90,10,1,C
238G,238G,2,518,560,42,90,10,1,C
238G,238G,2,568,584,16,90,10,1,C
238G,238G,2,644,669,25,90,10,1,C
238G,238G,2,755,777,22,90,10,1,C
238G,238G,2,798,818,20,90,10,1,C
238G,238G,2,823,851,28,90,10,1,C
238G,238G,2,869,881,12,90,10,1,C
238G,238G,2,908,922,14,90,10,1,C
238G,238G,2,927,970,43,90,10,1,C
238G,238G,2,987,1002,15,90,10,1,C
238G,238G,2,1035,1094,59,90,10,1,C
238G,238G,2,1173,1192,19,90,10,1,C
238G,238G,2,1277,1315,38,90,10,1,C
238G,238G,2,1320,1386,66,90,10,1,C
238G,238G,2,1404,1436,32,90,10,1,C
238G,238G,2,1445,1457,12,90,10,1,C
238G,238G,2,1520,1550,30,90,10,1,C
238G,238G,2,1683,1701,18,90,10,1,C
238G,238G,2,1706,1723,17,90,10,1,C
238G,238G,2,1744,1760,16,90,10,1,C
238G,238G,2,1855,1887,32,90,10,1,C
238G,238G,2,1913,1931,18,90,10,1,C
238G,238G,2,1949,1988,39,90,10,1,C
238G,238G,2,2008,2060,52,90,10,1,C
238G,238G,2,2066,2090,24,90,10,1,C
238G,238G,2,2115,2155,40,90,10,1,C
238G,238G,2,2172,2196,24,90,10,1,C
238G,238G,2,2214,2230,16,90,10,1,C
238G,238G,2,2252,2273,21,90,10,1,C
238G,238G,2,2315,2338,23,90,10,1,C
238G,238G,2,2362,2381,19,90,10,1,C
238G,238G,2,2390,2429,39,90,10,1,C
238G,238G,2,2483,2572,89,90,10,1,C
238G,238G,2,2681,2690,9,90,10,1,C
238G,238G,2,2697,2731,34,90,10,1,C
238G,238G,2,2737,2757,20,90,10,1,C
238G,238G,2,2762,2777,15,90,10,1,C
238G,238G,2,2786,2798,12,90,10,1,C
238G,238G,2,2810,2850,40,90,10,1,C
238G,238G,2,2935,2963,28,90,10,1,C
238G,238G,2,2977,3000,23,90,10,1,C
238G,238G,15,14,48,34,90,10,1,C
238G,238G,15,78,231,153,90,10,1,C
238G,238G,15,236,257,21,90,10,1,C
238G,238G,15,262,287,25,90,10,1,C
238G,238G,15,296,346,50,90,10,1,C
238G,238G,15,397,408,11,90,10,1,C
238G,238G,15,425,541,116,90,10,1,C
238G,238G,15,546,588,42,90,10,1,C
238G,238G,15,604,636,32,90,10,1,C
238G,238G,15,641,715,74,90,10,1,C
238G,238G,15,733,753,20,90,10,1,C
238G,238G,15,806,830,24,90,10,1,C
238G,238G,15,863,911,48,90,10,1,C
238G,238G,15,913,930,17,90,10,1,C
238G,238G,15,935,955,20,90,10,1,C
238G,238G,15,981,991,10,90,10,1,C
238G,238G,15,996,1037,41,90,10,1,C
238G,238G,15,1049,1072,23,90,10,1,C
238G,238G,15,1077,1097,20,90,10,1,C
238G,238G,15,1137,1151,14,90,10,1,C
238G,238G,15,1215,1241,26,90,10,1,C
238G,238G,15,1259,1281,22,90,10,1,C
238G,238G,15,1313,1328,15,90,10,1,C
238G,238G,15,1359,1380,21,90,10,1,C
238G,238G,15,1468,1482,14,90,10,1,C
238G,238G,15,1600,1621,21,90,10,1,C
238G,238G,15,1626,1647,21,90,10,1,C
238G,238G,15,1693,1708,15,90,10,1,C
238G,238G,15,1719,1740,21,90,10,1,C
238G,238G,15,1785,1820,35,90,10,1,C
238G,238G,15,1858,1905,47,90,10,1,C
238G,238G,15,1945,1963,18,90,10,1,C
238G,238G,15,2004,2055,51,90,10,1,C
238G,238G,15,2063,2077,14,90,10,1,C
238G,238G,15,2083,2094,11,90,10,1,C
238G,238G,15,2126,2142,16,90,10,1,C
238G,238G,15,2162,2181,19,90,10,1,C
238G,238G,15,2240,2267,27,90,10,1,C
238G,238G,15,2287,2323,36,90,10,1,C
238G,238G,15,2339,2350,11,90,10,1,C
238G,238G,15,2396,2437,41,90,10,1,C
238G,238G,15,2471,2491,20,90,10,1,C
238G,238G,15,2508,2531,23,90,10,1,C
238G,238G,15,2554,2570,16,90,10,1,C
238G,238G,15,2575,2590,15,90,10,1,C
238G,238G,15,2696,2757,61,90,10,1,C
238G,238G,15,2771,2808,37,90,10,1,C
238G,238G,15,2819,2927,108,90,10,1,C
238G,238G,15,2954,2972,18,90,10,1,C
238G,238G,28,4,37,33,90,10,1,C
238G,238G,28,112,155,43,90,10,1,C
238G,238G,28,170,188,18,90,10,1,C
238G,238G,28,231,256,25,90,10,1,C
238G,238G,28,265,289,24,90,10,1,C
238G,238G,28,322,343,21,90,10,1,C
238G,238G,28,365,398,33,90,10,1,C
238G,238G,28,404,424,20,90,10,1,C
238G,238G,28,438,459,21,90,10,1,C
238G,238G,28,465,524,59,90,10,1,C
238G,238G,28,529,544,15,90,10,1,C
238G,238G,28,558,568,10,90,10,1,C
238G,238G,28,574,606,32,90,10,1,C
238G,238G,28,614,626,12,90,10,1,C
238G,238G,28,630,642,12,90,10,1,C
238G,238G,28,650,662,12,90,10,1,C
238G,238G,28,766,781,15,90,10,1,C
238G,238G,28,787,804,17,90,10,1,C
238G,238G,28,810,835,25,90,10,1,C
238G,238G,28,863,874,11,90,10,1,C
238G,238G,28,887,900,13,90,10,1,C
238G,238G,28,910,934,24,90,10,1,C
238G,238G,28,970,1078,108,90,10,1,C
238G,238G,28,1126,1161,35,90,10,1,C
238G,238G,28,1166,1187,21,90,10,1,C
238G,238G,28,1196,1230,34,90,10,1,C
238G,238G,28,1244,1256,12,90,10,1,C
238G,238G,28,1281,1297,16,90,10,1,C
238G,238G,28,1302,1327,25,90,10,1,C
238G,238G,28,1331,1353,22,90,10,1,C
238G,238G,28,1371,1405,34,90,10,1,C
238G,238G,28,1410,1446,36,90,10,1,C
238G,238G,28,1457,1486,29,90,10,1,C
238G,238G,28,1504,1562,58,90,10,1,C
238G,238G,28,1591,1631,40,90,10,1,C
238G,238G,28,1638,1653,15,90,10,1,C
238G,238G,28,1675,1735,60,90,10,1,C
238G,238G,28,1741,1802,61,90,10,1,C
238G,238G,28,1827,1866,39,90,10,1,C
238G,238G,28,1872,1886,14,90,10,1,C
238G,238G,28,1954,2068,114,90,10,1,C
238G,238G,28,2079,2094,15,90,10,1,C
238G,238G,28,2104,2232,128,90,10,1,C
238G,238G,28,2266,2283,17,90,10,1,C
238G,238G,28,2316,2346,30,90,10,1,C
238G,238G,28,2370,2402,32,90,10,1,C
238G,238G,28,2407,2453,46,90,10,1,C
238G,238G,28,2487,2507,20,90,10,1,C
238G,238G,28,2512,2559,47,90,10,1,C
238G,238G,28,2546,2562,16,90,10,1,C
238G,238G,28,2571,2590,19,90,10,1,C
238G,238G,28,2600,2646,46,90,10,1,C
238G,238G,28,2677,2694,17,90,10,1,C
238G,238G,28,2733,2791,58,90,10,1,C
238G,238G,28,2802,2814,12,90,10,1,C
238G,238G,28,2832,2862,30,90,10,1,C
238G,238G,28,2874,2905,31,90,10,1,C
238G,238G,28,2919,2944,25,90,10,1,C
238G,238G,28,2954,3000,46,90,10,1,C
239A,239A,2,33,62,29,90,10,1,C
239A,239A,2,131,172,41,90,10,1,C
239A,239A,2,179,206,27,90,10,1,C
239A,239A,2,286,309,23,90,10,1,C
239A,239A,2,314,326,12,90,10,1,C
239A,239A,2,604,641,37,90,10,1,C
239A,239A,2,726,739,13,90,10,1,C
239A,239A,2,827,865,38,90,10,1,C
239A,239A,2,904,936,32,90,10,1,C
239A,239A,2,967,984,17,90,10,1,C
239A,239A,2,1070,1080,10,90,10,1,C
239A,239A,2,1120,1165,45,90,10,1,C
239A,239A,2,1197,1215,18,90,10,1,C
239A,239A,2,1293,1308,15,90,10,1,C
239A,239A,2,1416,1430,14,90,10,1,C
239A,239A,2,1582,1601,19,90,10,1,C
239A,239A,2,1644,1657,13,90,10,1,C
239A,239A,2,1690,1701,11,90,10,1,C
239A,239A,2,1803,1816,13,90,10,1,C
239A,239A,2,1964,1978,14,90,10,1,C
239A,239A,2,2037,2048,11,90,10,1,C
239A,239A,2,2060,2091,31,90,10,1,C
239A,239A,2,2175,2195,20,90,10,1,C
239A,239A,2,2238,2250,12,90,10,1,C
239A,239A,2,2284,2297,13,90,10,1,C
239A,239A,2,2320,2412,92,90,10,1,C
239A,239A,2,2458,2478,20,90,10,1,C
239A,239A,2,2515,2551,36,90,10,1,C
239A,239A,2,2590,2615,25,90,10,1,C
239A,239A,2,2647,2662,15,90,10,1,C
239A,239A,2,2682,2708,26,90,10,1,C
239A,239A,2,2767,2805,38,90,10,1,C
239A,239A,2,2878,2911,33,90,10,1,C
239A,239A,15,192,211,19,90,10,1,C
239A,239A,15,230,250,20,90,10,1,C
239A,239A,15,540,574,34,90,10,1,C
239A,239A,15,583,613,30,90,10,1,C
239A,239A,15,919,937,18,90,10,1,C
239A,239A,15,950,1005,55,90,10,1,C
239A,239A,15,1098,1140,42,90,10,1,C
239A,239A,15,1157,1172,15,90,10,1,C
239A,239A,15,1184,1226,42,90,10,1,C
239A,239A,15,1261,1282,21,90,10,1,C
239A,239A,15,1343,1380,37,90,10,1,C
239A,239A,15,1861,1878,17,90,10,1,C
239A,239A,15,2210,2229,19,90,10,1,C
239A,239A,15,2509,2537,28,90,10,1,C
239A,239A,15,2642,2662,20,90,10,1,C
239A,239A,15,2667,2688,21,90,10,1,C
239A,239A,15,2721,2737,16,90,10,1,C
239A,239A,15,2750,2762,12,90,10,1,C
239A,239A,28,10,21,11,90,10,1,C
239A,239A,28,41,52,11,90,10,1,C
239A,239A,28,222,234,12,90,10,1,C
239A,239A,28,452,467,15,90,10,1,C
239A,239A,28,608,636,28,90,10,1,C
239A,239A,28,774,795,21,90,10,1,C
239A,239A,28,830,864,34,90,10,1,C
239A,239A,28,1012,1049,37,90,10,1,C
239A,239A,28,1113,1159,46,90,10,1,C
239A,239A,28,1187,1254,67,90,10,1,C
239A,239A,28,1385,1543,158,90,10,1,C
239A,239A,28,1687,1723,36,90,10,1,C
239A,239A,28,1734,1746,12,90,10,1,C
239A,239A,28,1751,1798,47,90,10,1,C
239A,239A,28,1829,1840,11,90,10,1,C
239A,239A,28,1960,1983,23,90,10,1,C
239A,239A,28,2370,2386,16,90,10,1,C
239A,239A,28,2400,2412,12,90,10,1,C
239A,239A,28,2565,2583,18,90,10,1,C
239A,239A,28,2635,2647,12,90,10,1,C
239A,239A,28,2731,2750,19,90,10,1,C
239A,239A,28,2809,2822,13,90,10,1,C
239A,239A,28,2830,2841,11,90,10,1,C
239G,239G,2,2,25,23,90,10,1,C
239G,239G,2,36,85,49,90,10,1,C
239G,239G,2,106,161,55,90,10,1,C
239G,239G,2,177,235,58,90,10,1,C
239G,239G,2,257,313,56,90,10,1,C
239G,239G,2,320,346,26,90,10,1,C
239G,239G,2,379,394,15,90,10,1,C
239G,239G,2,434,507,73,90,10,1,C
239G,239G,2,535,573,38,90,10,1,C
239G,239G,2,579,602,23,90,10,1,C
239G,239G,2,610,637,27,90,10,1,C
239G,239G,2,651,695,44,90,10,1,C
239G,239G,2,714,777,63,90,10,1,C
239G,239G,2,798,839,41,90,10,1,C
239G,239G,2,850,863,13,90,10,1,C
239G,239G,2,894,1015,121,90,10,1,C
239G,239G,2,1052,1065,13,90,10,1,C
239G,239G,2,1071,1090,19,90,10,1,C
239G,239G,2,1098,1133,35,90,10,1,C
239G,239G,2,1157,1252,95,90,10,1,C
239G,239G,2,1290,1353,63,90,10,1,C
239G,239G,2,1345,1418,73,90,10,1,C
239G,239G,2,1463,1482,19,90,10,1,C
239G,239G,2,1488,1503,15,90,10,1,C
239G,239G,2,1549,1618,69,90,10,1,C
239G,239G,2,1623,1640,17,90,10,1,C
239G,239G,2,1672,1714,42,90,10,1,C
239G,239G,2,1741,1775,34,90,10,1,C
239G,239G,2,1800,1820,20,90,10,1,C
239G,239G,2,1878,1904,26,90,10,1,C
239G,239G,2,1982,2012,30,90,10,1,C
239G,239G,2,2020,2086,66,90,10,1,C
239G,239G,2,2131,2256,125,90,10,1,C
239G,239G,2,2267,2301,34,90,10,1,C
239G,239G,2,2308,2324,16,90,10,1,C
239G,239G,2,2344,2370,26,90,10,1,C
239G,239G,2,2386,2397,11,90,10,1,C
239G,239G,2,2418,2434,16,90,10,1,C
239G,239G,2,2465,2503,38,90,10,1,C
239G,239G,2,2520,2593,73,90,10,1,C
239G,239G,2,2604,2623,19,90,10,1,C
239G,239G,2,2654,2683,29,90,10,1,C
239G,239G,2,2701,2724,23,90,10,1,C
239G,239G,2,2733,2774,41,90,10,1,C
239G,239G,2,2821,2868,47,90,10,1,C
239G,239G,2,2878,2979,101,90,10,1,C
239G,239G,2,2983,3000,17,90,10,1,C
239G,239G,15,0,28,28,90,10,1,C
239G,239G,15,55,70,15,90,10,1,C
239G,239G,15,77,162,85,90,10,1,C
239G,239G,15,196,216,20,90,10,1,C
239G,239G,15,258,294,36,90,10,1,C
239G,239G,15,342,352,10,90,10,1,C
239G,239G,15,384,398,14,90,10,1,C
239G,239G,15,405,432,27,90,10,1,C
239G,239G,15,455,487,32,90,10,1,C
239G,239G,15,514,582,68,90,10,1,C
239G,239G,15,665,712,47,90,10,1,C
239G,239G,15,818,829,11,90,10,1,C
239G,239G,15,840,856,16,90,10,1,C
239G,239G,15,875,910,35,90,10,1,C
239G,239G,15,921,932,11,90,10,1,C
239G,239G,15,942,958,16,90,10,1,C
239G,239G,15,963,974,11,90,10,1,C
239G,239G,15,1026,1291,265,90,10,1,C
239G,239G,15,1298,1315,17,90,10,1,C
239G,239G,15,1452,1470,18,90,10,1,C
239G,239G,15,1502,1554,52,90,10,1,C
239G,239G,15,1567,1682,115,90,10,1,C
239G,239G,15,1711,1737,26,90,10,1,C
239G,239G,15,1770,1802,32,90,10,1,C
239G,239G,15,1815,1914,99,90,10,1,C
239G,239G,15,2026,2041,15,90,10,1,C
239G,239G,15,2076,2193,117,90,10,1,C
239G,239G,15,2225,2260,35,90,10,1,C
239G,239G,15,2280,2380,100,90,10,1,C
239G,239G,15,2465,2505,40,90,10,1,C
239G,239G,15,2510,2613,103,90,10,1,C
239G,239G,15,2635,2734,99,90,10,1,C
239G,239G,15,2805,2849,44,90,10,1,C
239G,239G,15,2862,2927,65,90,10,1,C
239G,239G,15,2980,3000,20,90,10,1,C
239G,239G,28,46,90,44,90,10,1,C
239G,239G,28,96,116,20,90,10,1,C
239G,239G,28,132,198,66,90,10,1,C
239G,239G,28,241,328,87,90,10,1,C
239G,239G,28,377,440,63,90,10,1,C
239G,239G,28,493,532,39,90,10,1,C
239G,239G,28,571,728,157,90,10,1,C
239G,239G,28,738,792,54,90,10,1,C
239G,239G,28,802,938,136,90,10,1,C
239G,239G,28,970,984,14,90,10,1,C
239G,239G,28,1158,1178,20,90,10,1,C
239G,239G,28,1197,1229,32,90,10,1,C
239G,239G,28,1249,1272,23,90,10,1,C
239G,239G,28,1286,1305,19,90,10,1,C
239G,239G,28,1320,1383,63,90,10,1,C
239G,239G,28,1351,1377,26,90,10,1,C
239G,239G,28,1443,1458,15,90,10,1,C
239G,239G,28,1467,1514,47,90,10,1,C
239G,239G,28,1524,1561,37,90,10,1,C
239G,239G,28,1580,1593,13,90,10,1,C
239G,239G,28,1598,1615,17,90,10,1,C
239G,239G,28,1626,1693,67,90,10,1,C
239G,239G,28,1719,1751,32,90,10,1,C
239G,239G,28,1784,1796,12,90,10,1,C
239G,239G,28,1853,1970,117,90,10,1,C
239G,239G,28,1999,2027,28,90,10,1,C
239G,239G,28,2100,2175,75,90,10,1,C
239G,239G,28,2191,2300,109,90,10,1,C
239G,239G,28,2335,2359,24,90,10,1,C
239G,239G,28,2377,2419,42,90,10,1,C
239G,239G,28,2443,2465,22,90,10,1,C
239G,239G,28,2526,2530,4,90,10,1,C
239G,239G,28,2541,2600,59,90,10,1,C
239G,239G,28,2631,2651,20,90,10,1,C
239G,239G,28,2663,2687,24,90,10,1,C
239G,239G,28,2733,2774,41,90,10,1,C
239G,239G,28,2831,2895,64,90,10,1,C
239G,239G,28,2919,2961,42,90,10,1,C
239G,239G,28,2984,3000,16,90,10,1,C
240A,240A,2,13,27,14,90,10,1,C
240A,240A,2,60,93,33,90,10,1,C
240A,240A,2,124,143,19,90,10,1,C
240A,240A,2,161,175,14,90,10,1,C
240A,240A,2,200,211,11,90,10,1,C
240A,240A,2,338,358,20,90,10,1,C
240A,240A,2,410,444,34,90,10,1,C
240A,240A,2,454,480,26,90,10,1,C
240A,240A,2,491,531,40,90,10,1,C
240A,240A,2,553,588,35,90,10,1,C
240A,240A,2,600,610,10,90,10,1,C
240A,240A,2,637,648,11,90,10,1,C
240A,240A,2,685,712,27,90,10,1,C
240A,240A,2,827,850,23,90,10,1,C
240A,240A,2,865,879,14,90,10,1,C
240A,240A,2,920,930,10,90,10,1,C
240A,240A,2,980,1022,42,90,10,1,C
240A,240A,2,1073,1092,19,90,10,1,C
240A,240A,2,1489,1507,18,90,10,1,C
240A,240A,2,1559,1588,29,90,10,1,C
240A,240A,2,1648,1660,12,90,10,1,C
240A,240A,2,1792,1820,28,90,10,1,C
240A,240A,2,1883,1914,31,90,10,1,C
240A,240A,2,2010,2078,68,90,10,1,C
240A,240A,2,2100,2118,18,90,10,1,C
240A,240A,2,2288,2318,30,90,10,1,C
240A,240A,2,2344,2358,14,90,10,1,C
240A,240A,2,2378,2408,30,90,10,1,C
240A,240A,2,2445,2466,21,90,10,1,C
240A,240A,2,2494,2508,14,90,10,1,C
240A,240A,2,2513,2526,13,90,10,1,C
240A,240A,2,2546,2558,12,90,10,1,C
240A,240A,2,2610,2625,15,90,10,1,C
240A,240A,2,2634,2650,16,90,10,1,C
240A,240A,2,2672,2696,24,90,10,1,C
240A,240A,2,2739,2752,13,90,10,1,C
240A,240A,2,2986,3000,14,90,10,1,C
240A,240A,15,41,76,35,90,10,1,C
240A,240A,15,131,150,19,90,10,1,C
240A,240A,15,199,232,33,90,10,1,C
240A,240A,15,257,304,47,90,10,1,C
240A,240A,15,344,402,58,90,10,1,C
240A,240A,15,443,490,47,90,10,1,C
240A,240A,15,595,621,26,90,10,1,C
240A,240A,15,643,717,74,90,10,1,C
240A,240A,15,1295,1307,12,90,10,1,C
240A,240A,15,1370,1381,11,90,10,1,C
240A,240A,15,1407,1422,15,90,10,1,C
240A,240A,15,1433,1581,148,90,10,1,C
240A,240A,15,1620,1634,14,90,10,1,C
240A,240A,15,1688,1705,17,90,10,1,C
240A,240A,15,1737,1750,13,90,10,1,C
240A,240A,15,1755,1767,12,90,10,1,C
240A,240A,15,1824,1862,38,90,10,1,C
240A,240A,15,1909,1924,15,90,10,1,C
240A,240A,15,1937,1952,15,90,10,1,C
240A,240A,15,1970,2002,32,90,10,1,C
240A,240A,15,2028,2055,27,90,10,1,C
240A,240A,15,2068,2090,22,90,10,1,C
240A,240A,15,2128,2145,17,90,10,1,C
240A,240A,15,2150,2164,14,90,10,1,C
240A,240A,15,2200,2228,28,90,10,1,C
240A,240A,15,2253,2264,11,90,10,1,C
240A,240A,15,2270,2283,13,90,10,1,C
240A,240A,15,2321,2375,54,90,10,1,C
240A,240A,15,2386,2407,21,90,10,1,C
240A,240A,15,2421,2449,28,90,10,1,C
240A,240A,15,2474,2487,13,90,10,1,C
240A,240A,15,2494,2524,30,90,10,1,C
240A,240A,15,2537,2593,56,90,10,1,C
240A,240A,15,2626,2645,19,90,10,1,C
240A,240A,15,2690,2704,14,90,10,1,C
240A,240A,15,2717,2737,20,90,10,1,C
240A,240A,15,2780,2803,23,90,10,1,C
240A,240A,15,2819,2873,54,90,10,1,C
240A,240A,15,2932,2946,14,90,10,1,C
240A,240A,15,2957,3000,43,90,10,1,C
240A,240A,28,120,130,10,90,10,1,C
240A,240A,28,163,190,27,90,10,1,C
240A,240A,28,220,255,35,90,10,1,C
240A,240A,28,279,290,11,90,10,1,C
240A,240A,28,510,523,13,90,10,1,C
240A,240A,28,555,573,18,90,10,1,C
240A,240A,28,585,598,13,90,10,1,C
240A,240A,28,629,650,21,90,10,1,C
240A,240A,28,703,726,23,90,10,1,C
240A,240A,28,762,773,11,90,10,1,C
240A,240A,28,916,928,12,90,10,1,C
240A,240A,28,951,992,41,90,10,1,C
240A,240A,28,1028,1049,21,90,10,1,C
240A,240A,28,1055,1075,20,90,10,1,C
240A,240A,28,1081,1108,27,90,10,1,C
240A,240A,28,1146,1208,62,90,10,1,C
240A,240A,28,1243,1285,42,90,10,1,C
240A,240A,28,1341,1363,22,90,10,1,C
240A,240A,28,1375,1443,68,90,10,1,C
240A,240A,28,1482,1499,17,90,10,1,C
240A,240A,28,1540,1556,16,90,10,1,C
240A,240A,28,1567,1609,42,90,10,1,C
240A,240A,28,1620,1675,55,90,10,1,C
240A,240A,28,1702,1736,34,90,10,1,C
240A,240A,28,1780,1844,64,90,10,1,C
240A,240A,28,1956,1983,27,90,10,1,C
240A,240A,28,2051,2082,31,90,10,1,C
240A,240A,28,2159,2182,23,90,10,1,C
240A,240A,28,2215,2270,55,90,10,1,C
240A,240A,28,2280,2298,18,90,10,1,C
240A,240A,28,2309,2334,25,90,10,1,C
240A,240A,28,2342,2374,32,90,10,1,C
240A,240A,28,2457,2476,19,90,10,1,C
240A,240A,28,2539,2557,18,90,10,1,C
240A,240A,28,2579,2590,11,90,10,1,C
240A,240A,28,2595,2608,13,90,10,1,C
240A,240A,28,2961,2977,16,90,10,1,C
240G,240G,2,0,21,21,90,10,1,C
240G,240G,2,26,47,21,90,10,1,C
240G,240G,2,77,89,12,90,10,1,C
240G,240G,2,100,116,16,90,10,1,C
240G,240G,2,185,206,21,90,10,1,C
240G,240G,2,221,242,21,90,10,1,C
240G,240G,2,255,266,11,90,10,1,C
240G,240G,2,349,365,16,90,10,1,C
240G,240G,2,576,598,22,90,10,1,C
240G,240G,2,850,876,26,90,10,1,C
240G,240G,2,885,921,36,90,10,1,C
240G,240G,2,1079,1107,28,90,10,1,C
240G,240G,2,1125,1138,13,90,10,1,C
240G,240G,2,1145,1160,15,90,10,1,C
240G,240G,2,1363,1380,17,90,10,1,C
240G,240G,2,1490,1533,43,90,10,1,C
240G,240G,2,1613,1628,15,90,10,1,C
240G,240G,2,1640,1660,20,90,10,1,C
240G,240G,2,1665,1680,15,90,10,1,C
240G,240G,2,1710,1750,40,90,10,1,C
240G,240G,2,1774,1794,20,90,10,1,C
240G,240G,2,1845,1861,16,90,10,1,C
240G,240G,2,1946,1956,10,90,10,1,C
240G,240G,2,1965,1977,12,90,10,1,C
240G,240G,2,1994,2010,16,90,10,1,C
240G,240G,2,2027,2041,14,90,10,1,C
240G,240G,2,2095,2108,13,90,10,1,C
240G,240G,2,2172,2184,12,90,10,1,C
240G,240G,2,2197,2221,24,90,10,1,C
240G,240G,2,2262,2287,25,90,10,1,C
240G,240G,2,2327,2348,21,90,10,1,C
240G,240G,2,2391,2414,23,90,10,1,C
240G,240G,2,2420,2432,12,90,10,1,C
240G,240G,2,2478,2494,16,90,10,1,C
240G,240G,2,2519,2529,10,90,10,1,C
240G,240G,2,2581,2605,24,90,10,1,C
240G,240G,2,2610,2621,11,90,10,1,C
240G,240G,2,2637,2660,23,90,10,1,C
240G,240G,2,2696,2706,10,90,10,1,C
240G,240G,2,2783,2797,14,90,10,1,C
240G,240G,2,2831,2849,18,90,10,1,C
240G,240G,2,2883,2900,17,90,10,1,C
240G,240G,2,2913,2923,10,90,10,1,C
240G,240G,2,2963,2989,26,90,10,1,C
240G,240G,15,16,31,15,90,10,1,C
240G,240G,15,40,51,11,90,10,1,C
240G,240G,15,204,220,16,90,10,1,C
240G,240G,15,267,280,13,90,10,1,C
240G,240G,15,544,575,31,90,10,1,C
240G,240G,15,772,824,52,90,10,1,C
240G,240G,15,900,915,15,90,10,1,C
240G,240G,15,1212,1223,11,90,10,1,C
240G,240G,15,1431,1444,13,90,10,1,C
240G,240G,15,1485,1500,15,90,10,1,C
240G,240G,15,1766,1799,33,90,10,1,C
240G,240G,15,1805,1835,30,90,10,1,C
240G,240G,15,1846,1880,34,90,10,1,C
240G,240G,15,1922,1957,35,90,10,1,C
240G,240G,15,2019,2044,25,90,10,1,C
240G,240G,15,2210,2220,10,90,10,1,C
240G,240G,15,2346,2360,14,90,10,1,C
240G,240G,15,2385,2410,25,90,10,1,C
240G,240G,15,2452,2515,63,90,10,1,C
240G,240G,15,2551,2567,16,90,10,1,C
240G,240G,15,2649,2665,16,90,10,1,C
240G,240G,15,2678,2710,32,90,10,1,C
240G,240G,28,141,160,19,90,10,1,C
240G,240G,28,173,192,19,90,10,1,C
240G,240G,28,264,296,32,90,10,1,C
240G,240G,28,303,342,39,90,10,1,C
240G,240G,28,421,444,23,90,10,1,C
240G,240G,28,493,505,12,90,10,1,C
240G,240G,28,542,562,20,90,10,1,C
240G,240G,28,635,650,15,90,10,1,C
240G,240G,28,656,667,11,90,10,1,C
240G,240G,28,718,746,28,90,10,1,C
240G,240G,28,812,850,38,90,10,1,C
240G,240G,28,915,933,18,90,10,1,C
240G,240G,28,1610,1624,14,90,10,1,C
240G,240G,28,1630,1642,12,90,10,1,C
240G,240G,28,1705,1727,22,90,10,1,C
240G,240G,28,1759,1772,13,90,10,1,C
240G,240G,28,1850,1871,21,90,10,1,C
240G,240G,28,1914,1935,21,90,10,1,C
240G,240G,28,1988,2004,16,90,10,1,C
240G,240G,28,2010,2021,11,90,10,1,C
240G,240G,28,2031,2041,10,90,10,1,C
240G,240G,28,2088,2104,16,90,10,1,C
240G,240G,28,2175,2193,18,90,10,1,C
240G,240G,28,2203,2220,17,90,10,1,C
240G,240G,28,2311,2333,22,90,10,1,C
240G,240G,28,2357,2386,29,90,10,1,C
240G,240G,28,2440,2462,22,90,10,1,C
240G,240G,28,2508,2523,15,90,10,1,C
240G,240G,28,2580,2600,20,90,10,1,C
240G,240G,28,2620,2640,20,90,10,1,C
240G,240G,28,2707,2720,13,90,10,1,C
240G,240G,28,2782,2804,22,90,10,1,C
240G,240G,28,2854,2867,13,90,10,1,C
240G,240G,28,2927,2962,35,90,10,1,C
241A,241A,2,25,35,10,90,10,1,C
241A,241A,2,61,87,26,90,10,1,C
241A,241A,2,103,123,20,90,10,1,C
241A,241A,2,197,256,59,90,10,1,C
241A,241A,2,398,420,22,90,10,1,C
241A,241A,2,1062,1077,15,90,10,1,C
241A,241A,2,1087,1100,13,90,10,1,C
241A,241A,2,1105,1120,15,90,10,1,C
241A,241A,2,1209,1221,12,90,10,1,C
241A,241A,2,1304,1324,20,90,10,1,C
241A,241A,2,1394,1412,18,90,10,1,C
241A,241A,2,1442,1459,17,90,10,1,C
241A,241A,2,1482,1507,25,90,10,1,C
241A,241A,2,1509,1519,10,90,10,1,C
241A,241A,2,1608,1621,13,90,10,1,C
241A,241A,2,1805,1817,12,90,10,1,C
241A,241A,2,2043,2056,13,90,10,1,C
241A,241A,2,2151,2166,15,90,10,1,C
241A,241A,2,2200,2217,17,90,10,1,C
241A,241A,2,2310,2322,12,90,10,1,C
241A,241A,2,2582,2622,40,90,10,1,C
241A,241A,2,2778,2794,16,90,10,1,C
241A,241A,2,2822,2839,17,90,10,1,C
241A,241A,2,2958,2989,31,90,10,1,C
241A,241A,15,10,25,15,90,10,1,C
241A,241A,15,50,83,33,90,10,1,C
241A,241A,15,132,156,24,90,10,1,C
241A,241A,15,230,252,22,90,10,1,C
241A,241A,15,374,389,15,90,10,1,C
241A,241A,15,508,521,13,90,10,1,C
241A,241A,15,575,585,10,90,10,1,C
241A,241A,15,620,640,20,90,10,1,C
241A,241A,15,652,668,16,90,10,1,C
241A,241A,15,735,746,11,90,10,1,C
241A,241A,15,751,761,10,90,10,1,C
241A,241A,15,766,782,16,90,10,1,C
241A,241A,15,861,871,10,90,10,1,C
241A,241A,15,922,953,31,90,10,1,C
241A,241A,15,960,980,20,90,10,1,C
241A,241A,15,1074,1093,19,90,10,1,C
241A,241A,15,1130,1143,13,90,10,1,C
241A,241A,15,1205,1225,20,90,10,1,C
241A,241A,15,1385,1400,15,90,10,1,C
241A,241A,15,1440,1455,15,90,10,1,C
241A,241A,15,1472,1488,16,90,10,1,C
241A,241A,15,1622,1637,15,90,10,1,C
241A,241A,15,1676,1687,11,90,10,1,C
241A,241A,15,2123,2134,11,90,10,1,C
241A,241A,15,2173,2186,13,90,10,1,C
241A,241A,15,2295,2307,12,90,10,1,C
241A,241A,28,32,46,14,90,10,1,C
241A,241A,28,92,116,24,90,10,1,C
241A,241A,28,153,163,10,90,10,1,C
241A,241A,28,170,183,13,90,10,1,C
241A,241A,28,223,234,11,90,10,1,C
241A,241A,28,263,284,21,90,10,1,C
241A,241A,28,292,307,15,90,10,1,C
241A,241A,28,339,353,14,90,10,1,C
241A,241A,28,580,590,10,90,10,1,C
241A,241A,28,675,694,19,90,10,1,C
241A,241A,28,728,740,12,90,10,1,C
241A,241A,28,925,943,18,90,10,1,C
241A,241A,28,1105,1130,25,90,10,1,C
241A,241A,28,1163,1174,11,90,10,1,C
241A,241A,28,1385,1405,20,90,10,1,C
241A,241A,28,1520,1533,13,90,10,1,C
241A,241A,28,1558,1572,14,90,10,1,C
241A,241A,28,1616,1630,14,90,10,1,C
241A,241A,28,1719,1731,12,90,10,1,C
241A,241A,28,1768,1787,19,90,10,1,C
241A,241A,28,1946,1959,13,90,10,1,C
241A,241A,28,1966,1981,15,90,10,1,C
241A,241A,28,2059,2081,22,90,10,1,C
241A,241A,28,2098,2120,22,90,10,1,C
241A,241A,28,2131,2154,23,90,10,1,C
241A,241A,28,2185,2204,19,90,10,1,C
241A,241A,28,2268,2281,13,90,10,1,C
241A,241A,28,2291,2303,12,90,10,1,C
241A,241A,28,2348,2360,12,90,10,1,C
241A,241A,28,2370,2383,13,90,10,1,C
241A,241A,28,2430,2443,13,90,10,1,C
241A,241A,28,2588,2600,12,90,10,1,C
241A,241A,28,2640,2650,10,90,10,1,C
241A,241A,28,2859,2880,21,90,10,1,C
241A,241A,28,2887,2897,10,90,10,1,C
241A,241A,28,2975,2997,22,90,10,1,C
241G,241G,2,12,23,11,90,10,1,C
241G,241G,2,33,43,10,90,10,1,C
241G,241G,2,67,90,23,90,10,1,C
241G,241G,2,190,206,16,90,10,1,C
241G,241G,2,241,265,24,90,10,1,C
241G,241G,2,295,313,18,90,10,1,C
241G,241G,2,330,340,10,90,10,1,C
241G,241G,2,396,410,14,90,10,1,C
241G,241G,2,624,649,25,90,10,1,C
241G,241G,2,665,682,17,90,10,1,C
241G,241G,2,775,803,28,90,10,1,C
241G,241G,2,817,841,24,90,10,1,C
241G,241G,2,847,868,21,90,10,1,C
241G,241G,2,873,894,21,90,10,1,C
241G,241G,2,1074,1091,17,90,10,1,C
241G,241G,2,1097,1115,18,90,10,1,C
241G,241G,2,1322,1335,13,90,10,1,C
241G,241G,2,1480,1511,31,90,10,1,C
241G,241G,2,1521,1540,19,90,10,1,C
241G,241G,2,1807,1833,26,90,10,1,C
241G,241G,2,1959,1970,11,90,10,1,C
241G,241G,2,2284,2297,13,90,10,1,C
241G,241G,2,2341,2353,12,90,10,1,C
241G,241G,2,2675,2693,18,90,10,1,C
241G,241G,2,2750,2776,26,90,10,1,C
241G,241G,2,2825,2849,24,90,10,1,C
241G,241G,2,2900,2925,25,90,10,1,C
241G,241G,2,2930,2940,10,90,10,1,C
241G,241G,15,0,34,34,90,10,1,C
241G,241G,15,120,135,15,90,10,1,C
241G,241G,15,468,481,13,90,10,1,C
241G,241G,15,538,552,14,90,10,1,C
241G,241G,15,767,780,13,90,10,1,C
241G,241G,15,856,873,17,90,10,1,C
241G,241G,15,1077,1113,36,90,10,1,C
241G,241G,15,1235,1248,13,90,10,1,C
241G,241G,15,1259,1273,14,90,10,1,C
241G,241G,15,1283,1296,13,90,10,1,C
241G,241G,15,1375,1389,14,90,10,1,C
241G,241G,15,1396,1410,14,90,10,1,C
241G,241G,15,1459,1480,21,90,10,1,C
241G,241G,15,2195,2206,11,90,10,1,C
241G,241G,15,2305,2324,19,90,10,1,C
241G,241G,15,2363,2397,34,90,10,1,C
241G,241G,15,2440,2471,31,90,10,1,C
241G,241G,15,2595,2636,41,90,10,1,C
241G,241G,15,2732,2743,11,90,10,1,C
241G,241G,15,2759,2772,13,90,10,1,C
241G,241G,15,2781,2803,22,90,10,1,C
241G,241G,15,2895,2909,14,90,10,1,C
241G,241G,28,238,260,22,90,10,1,C
241G,241G,28,335,355,20,90,10,1,C
241G,241G,28,465,479,14,90,10,1,C
241G,241G,28,894,907,13,90,10,1,C
241G,241G,28,1012,1025,13,90,10,1,C
241G,241G,28,1040,1065,25,90,10,1,C
241G,241G,28,1080,1103,23,90,10,1,C
241G,241G,28,1149,1165,16,90,10,1,C
241G,241G,28,1291,1316,25,90,10,1,C
241G,241G,28,1700,1733,33,90,10,1,C
241G,241G,28,1820,1832,12,90,10,1,C
241G,241G,28,1884,1894,10,90,10,1,C
241G,241G,28,1966,1983,17,90,10,1,C
241G,241G,28,1991,2005,14,90,10,1,C
241G,241G,28,2032,2047,15,90,10,1,C
241G,241G,28,2057,2080,23,90,10,1,C
241G,241G,28,2150,2162,12,90,10,1,C
241G,241G,28,2360,2373,13,90,10,1,C
241G,241G,28,2450,2465,15,90,10,1,C
241G,241G,28,2501,2526,25,90,10,1,C
241G,241G,28,2562,2572,10,90,10,1,C
241G,241G,28,2788,2810,22,90,10,1,C
241G,241G,28,2900,2913,13,90,10,1,C
242A,242A,2,18,35,17,90,10,1,C
242A,242A,2,48,64,16,90,10,1,C
242A,242A,2,178,190,12,90,10,1,C
242A,242A,2,414,433,19,90,10,1,C
242A,242A,2,444,458,14,90,10,1,C
242A,242A,2,492,506,14,90,10,1,C
242A,242A,2,687,709,22,90,10,1,C
242A,242A,2,718,731,13,90,10,1,C
242A,242A,2,891,909,18,90,10,1,C
242A,242A,2,956,977,21,90,10,1,C
242A,242A,2,1066,1081,15,90,10,1,C
242A,242A,2,1204,1223,19,90,10,1,C
242A,242A,2,1239,1266,27,90,10,1,C
242A,242A,2,1305,1318,13,90,10,1,C
242A,242A,2,1324,1342,18,90,10,1,C
242A,242A,2,1537,1556,19,90,10,1,C
242A,242A,2,1565,1605,40,90,10,1,C
242A,242A,2,1685,1695,10,90,10,1,C
242A,242A,2,1740,1752,12,90,10,1,C
242A,242A,2,1757,1789,32,90,10,1,C
242A,242A,2,1824,1843,19,90,10,1,C
242A,242A,2,2004,2017,13,90,10,1,C
242A,242A,2,2053,2083,30,90,10,1,C
242A,242A,2,2095,2119,24,90,10,1,C
242A,242A,2,2125,2155,30,90,10,1,C
242A,242A,2,2161,2190,29,90,10,1,C
242A,242A,2,2264,2294,30,90,10,1,C
242A,242A,2,2550,2561,11,90,10,1,C
242A,242A,2,2630,2640,10,90,10,1,C
242A,242A,2,2650,2660,10,90,10,1,C
242A,242A,2,2751,2764,13,90,10,1,C
242A,242A,2,2966,2980,14,90,10,1,C
242A,242A,15,55,78,23,90,10,1,C
242A,242A,15,89,100,11,90,10,1,C
242A,242A,15,300,320,20,90,10,1,C
242A,242A,15,348,360,12,90,10,1,C
242A,242A,15,389,410,21,90,10,1,C
242A,242A,15,548,570,22,90,10,1,C
242A,242A,15,637,658,21,90,10,1,C
242A,242A,15,694,705,11,90,10,1,C
242A,242A,15,745,760,15,90,10,1,C
242A,242A,15,810,824,14,90,10,1,C
242A,242A,15,893,903,10,90,10,1,C
242A,242A,15,1065,1077,12,90,10,1,C
242A,242A,15,1089,1108,19,90,10,1,C
242A,242A,15,1117,1127,10,90,10,1,C
242A,242A,15,1132,1160,28,90,10,1,C
242A,242A,15,1212,1224,12,90,10,1,C
242A,242A,15,1290,1305,15,90,10,1,C
242A,242A,15,1323,1342,19,90,10,1,C
242A,242A,15,1362,1380,18,90,10,1,C
242A,242A,15,1394,1405,11,90,10,1,C
242A,242A,15,1419,1435,16,90,10,1,C
242A,242A,15,1482,1503,21,90,10,1,C
242A,242A,15,1562,1574,12,90,10,1,C
242A,242A,15,1594,1641,47,90,10,1,C
242A,242A,15,1677,1692,15,90,10,1,C
242A,242A,15,1706,1722,16,90,10,1,C
242A,242A,15,1731,1760,29,90,10,1,C
242A,242A,15,1824,1836,12,90,10,1,C
242A,242A,15,2034,2095,61,90,10,1,C
242A,242A,15,2113,2151,38,90,10,1,C
242A,242A,15,2194,2235,41,90,10,1,C
242A,242A,15,2265,2276,11,90,10,1,C
242A,242A,15,2293,2310,17,90,10,1,C
242A,242A,15,2326,2351,25,90,10,1,C
242A,242A,15,2378,2398,20,90,10,1,C
242A,242A,15,2405,2433,28,90,10,1,C
242A,242A,15,2636,2666,30,90,10,1,C
242A,242A,15,2683,2696,13,90,10,1,C
242A,242A,15,2702,2713,11,90,10,1,C
242A,242A,15,2766,2791,25,90,10,1,C
242A,242A,15,2812,2870,58,90,10,1,C
242A,242A,15,2910,2944,34,90,10,1,C
242A,242A,28,39,55,16,90,10,1,C
242A,242A,28,129,141,12,90,10,1,C
242A,242A,28,152,167,15,90,10,1,C
242A,242A,28,392,413,21,90,10,1,C
242A,242A,28,420,433,13,90,10,1,C
242A,242A,28,451,463,12,90,10,1,C
242A,242A,28,502,516,14,90,10,1,C
242A,242A,28,610,621,11,90,10,1,C
242A,242A,28,660,681,21,90,10,1,C
242A,242A,28,705,718,13,90,10,1,C
242A,242A,28,801,820,19,90,10,1,C
242A,242A,28,836,852,16,90,10,1,C
242A,242A,28,926,936,10,90,10,1,C
242A,242A,28,941,954,13,90,10,1,C
242A,242A,28,1013,1037,24,90,10,1,C
242A,242A,28,1190,1208,18,90,10,1,C
242A,242A,28,1246,1281,35,90,10,1,C
242A,242A,28,1366,1380,14,90,10,1,C
242A,242A,28,1464,1490,26,90,10,1,C
242A,242A,28,1495,1505,10,90,10,1,C
242A,242A,28,1562,1589,27,90,10,1,C
242A,242A,28,1596,1612,16,90,10,1,C
242A,242A,28,1674,1708,34,90,10,1,C
242A,242A,28,1713,1727,14,90,10,1,C
242A,242A,28,1734,1748,14,90,10,1,C
242A,242A,28,1844,1864,20,90,10,1,C
242A,242A,28,1945,1960,15,90,10,1,C
242A,242A,28,2045,2065,20,90,10,1,C
242A,242A,28,2110,2133,23,90,10,1,C
242A,242A,28,2220,2233,13,90,10,1,C
242A,242A,28,2360,2375,15,90,10,1,C
242A,242A,28,2373,2395,22,90,10,1,C
242A,242A,28,2415,2443,28,90,10,1,C
242A,242A,28,2478,2495,17,90,10,1,C
242A,242A,28,2500,2511,11,90,10,1,C
242A,242A,28,2585,2610,25,90,10,1,C
242A,242A,28,2634,2659,25,90,10,1,C
242A,242A,28,2686,2709,23,90,10,1,C
242A,242A,28,2721,2734,13,90,10,1,C
242A,242A,28,2745,2765,20,90,10,1,C
242A,242A,28,2811,2855,44,90,10,1,C
242A,242A,28,2871,2897,26,90,10,1,C
242A,242A,28,2907,2919,12,90,10,1,C
242A,242A,28,2938,2946,8,90,10,1,C
242A,242A,28,2953,3000,47,90,10,1,C
242G,242G,2,25,63,38,90,10,1,C
242G,242G,2,73,88,15,90,10,1,C
242G,242G,2,94,105,11,90,10,1,C
242G,242G,2,139,173,34,90,10,1,C
242G,242G,2,220,230,10,90,10,1,C
242G,242G,2,354,387,33,90,10,1,C
242G,242G,2,430,440,10,90,10,1,C
242G,242G,2,502,530,28,90,10,1,C
242G,242G,2,536,564,28,90,10,1,C
242G,242G,2,710,731,21,90,10,1,C
242G,242G,2,837,855,18,90,10,1,C
242G,242G,2,939,962,23,90,10,1,C
242G,242G,2,1026,1055,29,90,10,1,C
242G,242G,2,1072,1084,12,90,10,1,C
242G,242G,2,1101,1118,17,90,10,1,C
242G,242G,2,1278,1305,27,90,10,1,C
242G,242G,2,1653,1668,15,90,10,1,C
242G,242G,2,1736,1751,15,90,10,1,C
242G,242G,2,1860,1870,10,90,10,1,C
242G,242G,2,1927,1968,41,90,10,1,C
242G,242G,2,1980,2003,23,90,10,1,C
242G,242G,2,2065,2090,25,90,10,1,C
242G,242G,2,2138,2154,16,90,10,1,C
242G,242G,2,2174,2188,14,90,10,1,C
242G,242G,2,2261,2275,14,90,10,1,C
242G,242G,2,2640,2650,10,90,10,1,C
242G,242G,2,2941,2957,16,90,10,1,C
242G,242G,15,0,18,18,90,10,1,C
242G,242G,15,61,111,50,90,10,1,C
242G,242G,15,203,224,21,90,10,1,C
242G,242G,15,260,297,37,90,10,1,C
242G,242G,15,339,410,71,90,10,1,C
242G,242G,15,424,437,13,90,10,1,C
242G,242G,15,522,535,13,90,10,1,C
242G,242G,15,540,550,10,90,10,1,C
242G,242G,15,560,588,28,90,10,1,C
242G,242G,15,603,615,12,90,10,1,C
242G,242G,15,630,640,10,90,10,1,C
242G,242G,15,662,680,18,90,10,1,C
242G,242G,15,790,813,23,90,10,1,C
242G,242G,15,849,882,33,90,10,1,C
242G,242G,15,887,912,25,90,10,1,C
242G,242G,15,936,950,14,90,10,1,C
242G,242G,15,1020,1035,15,90,10,1,C
242G,242G,15,1075,1113,38,90,10,1,C
242G,242G,15,1135,1154,19,90,10,1,C
242G,242G,15,1193,1220,27,90,10,1,C
242G,242G,15,1245,1261,16,90,10,1,C
242G,242G,15,1268,1282,14,90,10,1,C
242G,242G,15,1320,1359,39,90,10,1,C
242G,242G,15,1668,1689,21,90,10,1,C
242G,242G,15,1744,1769,25,90,10,1,C
242G,242G,15,1775,1796,21,90,10,1,C
242G,242G,15,1810,1835,25,90,10,1,C
242G,242G,15,1840,1851,11,90,10,1,C
242G,242G,15,1890,1922,32,90,10,1,C
242G,242G,15,2031,2077,46,90,10,1,C
242G,242G,15,2159,2178,19,90,10,1,C
242G,242G,15,2183,2198,15,90,10,1,C
242G,242G,15,2263,2278,15,90,10,1,C
242G,242G,15,2298,2315,17,90,10,1,C
242G,242G,15,2390,2400,10,90,10,1,C
242G,242G,15,2470,2485,15,90,10,1,C
242G,242G,15,2513,2525,12,90,10,1,C
242G,242G,15,2539,2557,18,90,10,1,C
242G,242G,15,2582,2594,12,90,10,1,C
242G,242G,15,2599,2614,15,90,10,1,C
242G,242G,15,2683,2695,12,90,10,1,C
242G,242G,15,2745,2765,20,90,10,1,C
242G,242G,15,2770,2800,30,90,10,1,C
242G,242G,15,2841,2874,33,90,10,1,C
242G,242G,15,2952,2974,22,90,10,1,C
242G,242G,28,80,99,19,90,10,1,C
242G,242G,28,104,115,11,90,10,1,C
242G,242G,28,223,260,37,90,10,1,C
242G,242G,28,390,402,12,90,10,1,C
242G,242G,28,499,522,23,90,10,1,C
242G,242G,28,688,708,20,90,10,1,C
242G,242G,28,785,795,10,90,10,1,C
242G,242G,28,878,892,14,90,10,1,C
242G,242G,28,900,927,27,90,10,1,C
242G,242G,28,1051,1065,14,90,10,1,C
242G,242G,28,1131,1157,26,90,10,1,C
242G,242G,28,1248,1260,12,90,10,1,C
242G,242G,28,1414,1430,16,90,10,1,C
242G,242G,28,1462,1482,20,90,10,1,C
242G,242G,28,1490,1520,30,90,10,1,C
242G,242G,28,1902,1915,13,90,10,1,C
242G,242G,28,2169,2210,41,90,10,1,C
242G,242G,28,2231,2253,22,90,10,1,C
242G,242G,28,2497,2522,25,90,10,1,C
242G,242G,28,2830,2842,12,90,10,1,C
242G,242G,28,2899,2927,28,90,10,1,C
242G,242G,28,2932,2951,19,90,10,1,C
243A,243A,2,805,825,20,90,10,1,C
243A,243A,2,883,887,4,90,10,1,C
243A,243A,2,900,920,20,90,10,1,C
243A,243A,2,1005,1015,10,90,10,1,C
243A,243A,2,1055,1100,45,90,10,1,C
243A,243A,2,1327,1343,16,90,10,1,C
243A,243A,2,1396,1407,11,90,10,1,C
243A,243A,2,1498,1538,40,90,10,1,C
243A,243A,2,1583,1613,30,90,10,1,C
243A,243A,2,1638,1650,12,90,10,1,C
243A,243A,2,1700,1711,11,90,10,1,C
243A,243A,2,1942,1976,34,90,10,1,C
243A,243A,2,2025,2049,24,90,10,1,C
243A,243A,15,930,951,21,90,10,1,C
243A,243A,15,1880,1890,10,90,10,1,C
243A,243A,15,2249,2261,12,90,10,1,C
243A,243A,15,2535,2547,12,90,10,1,C
243A,243A,15,2850,2871,21,90,10,1,C
243A,243A,15,2963,2973,10,90,10,1,C
243A,243A,28,232,248,16,90,10,1,C
243A,243A,28,990,1004,14,90,10,1,C
243A,243A,28,1059,1071,12,90,10,1,C
243A,243A,28,1180,1200,20,90,10,1,C
243A,243A,28,1309,1325,16,90,10,1,C
243A,243A,28,1481,1509,28,90,10,1,C
243A,243A,28,1549,1570,21,90,10,1,C
243A,243A,28,1680,1695,15,90,10,1,C
243A,243A,28,1905,1915,10,90,10,1,C
243A,243A,28,2240,2287,47,90,10,1,C
243A,243A,28,2303,2325,22,90,10,1,C
243A,243A,28,2336,2348,12,90,10,1,C
243A,243A,28,2493,2517,24,90,10,1,C
243A,243A,28,2530,2592,62,90,10,1,C
243A,243A,28,2643,2655,12,90,10,1,C
243G,243G,2,0,20,20,90,10,1,C
243G,243G,2,114,191,77,90,10,1,C
243G,243G,2,202,219,17,90,10,1,C
243G,243G,2,230,262,32,90,10,1,C
243G,243G,2,272,310,38,90,10,1,C
243G,243G,2,317,340,23,90,10,1,C
243G,243G,2,345,380,35,90,10,1,C
243G,243G,2,390,445,55,90,10,1,C
243G,243G,2,455,484,29,90,10,1,C
243G,243G,2,623,640,17,90,10,1,C
243G,243G,2,659,670,11,90,10,1,C
243G,243G,2,678,747,69,90,10,1,C
243G,243G,2,760,787,27,90,10,1,C
243G,243G,2,804,818,14,90,10,1,C
243G,243G,2,830,840,10,90,10,1,C
243G,243G,2,845,859,14,90,10,1,C
243G,243G,2,875,890,15,90,10,1,C
243G,243G,2,904,939,35,90,10,1,C
243G,243G,2,955,987,32,90,10,1,C
243G,243G,2,993,1011,18,90,10,1,C
243G,243G,2,1019,1051,32,90,10,1,C
243G,243G,2,1075,1087,12,90,10,1,C
243G,243G,2,1095,1126,31,90,10,1,C
243G,243G,2,1132,1157,25,90,10,1,C
243G,243G,2,1170,1170,0,90,10,1,C
243G,243G,2,1197,1310,113,90,10,1,C
243G,243G,2,1320,1356,36,90,10,1,C
243G,243G,2,1418,1430,12,90,10,1,C
243G,243G,2,1436,1457,21,90,10,1,C
243G,243G,2,1474,1495,21,90,10,1,C
243G,243G,2,1500,1514,14,90,10,1,C
243G,243G,2,1573,1549,-24,90,10,1,C
243G,243G,2,1596,1610,14,90,10,1,C
243G,243G,2,1625,1649,24,90,10,1,C
243G,243G,2,1653,1665,12,90,10,1,C
243G,243G,2,1671,1733,62,90,10,1,C
243G,243G,2,1750,1791,41,90,10,1,C
243G,243G,2,1805,1832,27,90,10,1,C
243G,243G,2,1870,1884,14,90,10,1,C
243G,243G,2,1912,1924,12,90,10,1,C
243G,243G,2,1931,1941,10,90,10,1,C
243G,243G,2,1947,1960,13,90,10,1,C
243G,243G,2,2117,2145,28,90,10,1,C
243G,243G,2,2249,2324,75,90,10,1,C
243G,243G,2,2356,2367,11,90,10,1,C
243G,243G,2,2390,2430,40,90,10,1,C
243G,243G,2,2638,2652,14,90,10,1,C
243G,243G,2,2672,2701,29,90,10,1,C
243G,243G,2,2769,2818,49,90,10,1,C
243G,243G,2,2887,2928,41,90,10,1,C
243G,243G,2,2966,3000,34,90,10,1,C
243G,243G,15,0,56,56,90,10,1,C
243G,243G,15,73,101,28,90,10,1,C
243G,243G,15,126,155,29,90,10,1,C
243G,243G,15,187,221,34,90,10,1,C
243G,243G,15,233,249,16,90,10,1,C
243G,243G,15,296,314,18,90,10,1,C
243G,243G,15,418,430,12,90,10,1,C
243G,243G,15,465,541,76,90,10,1,C
243G,243G,15,554,575,21,90,10,1,C
243G,243G,15,612,674,62,90,10,1,C
243G,243G,15,691,720,29,90,10,1,C
243G,243G,15,751,811,60,90,10,1,C
243G,243G,15,880,891,11,90,10,1,C
243G,243G,15,925,947,22,90,10,1,C
243G,243G,15,965,1000,35,90,10,1,C
243G,243G,15,1009,1027,18,90,10,1,C
243G,243G,15,1051,1124,73,90,10,1,C
243G,243G,15,1216,1230,14,90,10,1,C
243G,243G,15,1250,1260,10,90,10,1,C
243G,243G,15,1303,1321,18,90,10,1,C
243G,243G,15,1337,1357,20,90,10,1,C
243G,243G,15,1378,1400,22,90,10,1,C
243G,243G,15,1596,1651,55,90,10,1,C
243G,243G,15,1664,1764,100,90,10,1,C
243G,243G,15,1775,1827,52,90,10,1,C
243G,243G,15,1901,1975,74,90,10,1,C
243G,243G,15,2021,2062,41,90,10,1,C
243G,243G,15,2071,2142,71,90,10,1,C
243G,243G,15,2189,2220,31,90,10,1,C
243G,243G,15,2240,2333,93,90,10,1,C
243G,243G,15,2376,2412,36,90,10,1,C
243G,243G,15,2431,2452,21,90,10,1,C
243G,243G,15,2464,2483,19,90,10,1,C
243G,243G,15,2490,2506,16,90,10,1,C
243G,243G,15,2522,2562,40,90,10,1,C
243G,243G,15,2610,2622,12,90,10,1,C
243G,243G,15,2643,2677,34,90,10,1,C
243G,243G,15,2689,2710,21,90,10,1,C
243G,243G,15,2775,2794,19,90,10,1,C
243G,243G,15,2817,2829,12,90,10,1,C
243G,243G,15,2840,2883,43,90,10,1,C
243G,243G,28,30,44,14,90,10,1,C
243G,243G,28,65,78,13,90,10,1,C
243G,243G,28,107,156,49,90,10,1,C
243G,243G,28,166,398,232,90,10,1,C
243G,243G,28,403,503,100,90,10,1,C
243G,243G,28,508,536,28,90,10,1,C
243G,243G,28,623,650,27,90,10,1,C
243G,243G,28,661,680,19,90,10,1,C
243G,243G,28,702,712,10,90,10,1,C
243G,243G,28,759,780,21,90,10,1,C
243G,243G,28,817,836,19,90,10,1,C
243G,243G,28,865,887,22,90,10,1,C
243G,243G,28,905,929,24,90,10,1,C
243G,243G,28,948,1024,76,90,10,1,C
243G,243G,28,1047,1063,16,90,10,1,C
243G,243G,28,1070,1088,18,90,10,1,C
243G,243G,28,1113,1144,31,90,10,1,C
243G,243G,28,1154,1220,66,90,10,1,C
243G,243G,28,1248,1318,70,90,10,1,C
243G,243G,28,1342,1357,15,90,10,1,C
243G,243G,28,1388,1411,23,90,10,1,C
243G,243G,28,1458,1512,54,90,10,1,C
243G,243G,28,1520,1539,19,90,10,1,C
243G,243G,28,1544,1604,60,90,10,1,C
243G,243G,28,1625,1668,43,90,10,1,C
243G,243G,28,1718,1749,31,90,10,1,C
243G,243G,28,1745,1790,45,90,10,1,C
243G,243G,28,1785,1820,35,90,10,1,C
243G,243G,28,1839,1851,12,90,10,1,C
243G,243G,28,1906,1920,14,90,10,1,C
243G,243G,28,1990,2002,12,90,10,1,C
243G,243G,28,2020,2035,15,90,10,1,C
243G,243G,28,2050,2080,30,90,10,1,C
243G,243G,28,2100,2122,22,90,10,1,C
243G,243G,28,2170,2200,30,90,10,1,C
243G,243G,28,2231,2256,25,90,10,1,C
243G,243G,28,2304,2316,12,90,10,1,C
243G,243G,28,2326,2338,12,90,10,1,C
243G,243G,28,2356,2423,67,90,10,1,C
243G,243G,28,2470,2483,13,90,10,1,C
243G,243G,28,2494,2543,49,90,10,1,C
243G,243G,28,2550,2572,22,90,10,1,C
243G,243G,28,2580,2644,64,90,10,1,C
243G,243G,28,2658,2729,71,90,10,1,C
243G,243G,28,2746,3000,254,90,10,1,C
244A,244A,2,117,139,22,90,10,1,C
244A,244A,2,238,253,15,90,10,1,C
244A,244A,2,512,545,33,90,10,1,C
244A,244A,2,552,588,36,90,10,1,C
244A,244A,2,602,650,48,90,10,1,C
244A,244A,2,665,696,31,90,10,1,C
244A,244A,2,695,707,12,90,10,1,C
244A,244A,2,730,808,78,90,10,1,C
244A,244A,2,866,877,11,90,10,1,C
244A,244A,2,886,924,38,90,10,1,C
244A,244A,2,970,1003,33,90,10,1,C
244A,244A,2,1013,1024,11,90,10,1,C
244A,244A,2,1049,1077,28,90,10,1,C
244A,244A,2,1087,1110,23,90,10,1,C
244A,244A,2,1191,1209,18,90,10,1,C
244A,244A,2,1246,1265,19,90,10,1,C
244A,244A,2,1332,1365,33,90,10,1,C
244A,244A,2,1406,1437,31,90,10,1,C
244A,244A,2,1460,1493,33,90,10,1,C
244A,244A,2,1597,1611,14,90,10,1,C
244A,244A,2,1641,1688,47,90,10,1,C
244A,244A,2,1736,1766,30,90,10,1,C
244A,244A,2,1850,1873,23,90,10,1,C
244A,244A,2,1960,1989,29,90,10,1,C
244A,244A,2,2074,2086,12,90,10,1,C
244A,244A,2,2185,2196,11,90,10,1,C
244A,244A,2,2335,2350,15,90,10,1,C
244A,244A,2,2615,2634,19,90,10,1,C
244A,244A,2,2701,2720,19,90,10,1,C
244A,244A,2,2825,2837,12,90,10,1,C
244A,244A,15,224,255,31,90,10,1,C
244A,244A,15,268,324,56,90,10,1,C
244A,244A,15,329,352,23,90,10,1,C
244A,244A,15,380,415,35,90,10,1,C
244A,244A,15,493,506,13,90,10,1,C
244A,244A,15,523,576,53,90,10,1,C
244A,244A,15,614,639,25,90,10,1,C
244A,244A,15,690,711,21,90,10,1,C
244A,244A,15,829,853,24,90,10,1,C
244A,244A,15,884,945,61,90,10,1,C
244A,244A,15,1061,1073,12,90,10,1,C
244A,244A,15,1320,1335,15,90,10,1,C
244A,244A,15,1354,1406,52,90,10,1,C
244A,244A,15,1416,1440,24,90,10,1,C
244A,244A,15,1506,1526,20,90,10,1,C
244A,244A,15,1535,1562,27,90,10,1,C
244A,244A,15,1586,1601,15,90,10,1,C
244A,244A,15,1645,1657,12,90,10,1,C
244A,244A,15,2012,2027,15,90,10,1,C
244A,244A,15,2067,2131,64,90,10,1,C
244A,244A,15,2161,2172,11,90,10,1,C
244A,244A,15,2285,2303,18,90,10,1,C
244A,244A,15,2344,2363,19,90,10,1,C
244A,244A,15,2395,2409,14,90,10,1,C
244A,244A,15,2450,2483,33,90,10,1,C
244A,244A,15,2507,2517,10,90,10,1,C
244A,244A,15,2522,2575,53,90,10,1,C
244A,244A,15,2620,2637,17,90,10,1,C
244A,244A,15,2720,2805,85,90,10,1,C
244A,244A,15,2830,2870,40,90,10,1,C
244A,244A,15,2932,2954,22,90,10,1,C
244A,244A,28,103,114,11,90,10,1,C
244A,244A,28,160,181,21,90,10,1,C
244A,244A,28,303,345,42,90,10,1,C
244A,244A,28,431,450,19,90,10,1,C
244A,244A,28,500,512,12,90,10,1,C
244A,244A,28,620,641,21,90,10,1,C
244A,244A,28,746,780,34,90,10,1,C
244A,244A,28,929,940,11,90,10,1,C
244A,244A,28,988,1013,25,90,10,1,C
244A,244A,28,1051,1071,20,90,10,1,C
244A,244A,28,1100,1112,12,90,10,1,C
244A,244A,28,1370,1386,16,90,10,1,C
244A,244A,28,1395,1424,29,90,10,1,C
244A,244A,28,1506,1526,20,90,10,1,C
244A,244A,28,1743,1754,11,90,10,1,C
244A,244A,28,1780,1805,25,90,10,1,C
244A,244A,28,1878,1894,16,90,10,1,C
244A,244A,28,1948,1960,12,90,10,1,C
244A,244A,28,2092,2115,23,90,10,1,C
244A,244A,28,2253,2270,17,90,10,1,C
244A,244A,28,2310,2349,39,90,10,1,C
244A,244A,28,2400,2413,13,90,10,1,C
244A,244A,28,2459,2515,56,90,10,1,C
244A,244A,28,2610,2622,12,90,10,1,C
244A,244A,28,2772,2784,12,90,10,1,C
244A,244A,28,2810,2825,15,90,10,1,C
244G,244G,2,16,52,36,90,10,1,C
244G,244G,2,58,75,17,90,10,1,C
244G,244G,2,95,231,136,90,10,1,C
244G,244G,2,237,266,29,90,10,1,C
244G,244G,2,271,323,52,90,10,1,C
244G,244G,2,333,350,17,90,10,1,C
244G,244G,2,357,370,13,90,10,1,C
244G,244G,2,380,530,150,90,10,1,C
244G,244G,2,539,550,11,90,10,1,C
244G,244G,2,565,628,63,90,10,1,C
244G,244G,2,625,645,20,90,10,1,C
244G,244G,2,650,710,60,90,10,1,C
244G,244G,2,730,750,20,90,10,1,C
244G,244G,2,790,851,61,90,10,1,C
244G,244G,2,856,894,38,90,10,1,C
244G,244G,2,908,950,42,90,10,1,C
244G,244G,2,961,986,25,90,10,1,C
244G,244G,2,997,1051,54,90,10,1,C
244G,244G,2,1067,1115,48,90,10,1,C
244G,244G,2,1221,1245,24,90,10,1,C
244G,244G,2,1287,1343,56,90,10,1,C
244G,244G,2,1391,1461,70,90,10,1,C
244G,244G,2,1436,1540,104,90,10,1,C
244G,244G,2,1570,1630,60,90,10,1,C
244G,244G,2,1645,1662,17,90,10,1,C
244G,244G,2,1675,1685,10,90,10,1,C
244G,244G,2,1704,1863,159,90,10,1,C
244G,244G,2,1870,1884,14,90,10,1,C
244G,244G,2,1903,1957,54,90,10,1,C
244G,244G,2,1970,1985,15,90,10,1,C
244G,244G,2,1991,2102,111,90,10,1,C
244G,244G,2,2107,2133,26,90,10,1,C
244G,244G,2,2140,2181,41,90,10,1,C
244G,244G,2,2220,2236,16,90,10,1,C
244G,244G,2,2242,2259,17,90,10,1,C
244G,244G,2,2330,2363,33,90,10,1,C
244G,244G,2,2386,2583,197,90,10,1,C
244G,244G,2,2589,2614,25,90,10,1,C
244G,244G,2,2628,2682,54,90,10,1,C
244G,244G,2,2704,2718,14,90,10,1,C
244G,244G,2,2730,2760,30,90,10,1,C
244G,244G,2,2767,2829,62,90,10,1,C
244G,244G,2,2834,2852,18,90,10,1,C
244G,244G,2,2859,2897,38,90,10,1,C
244G,244G,2,2914,2954,40,90,10,1,C
244G,244G,15,31,45,14,90,10,1,C
244G,244G,15,115,142,27,90,10,1,C
244G,244G,15,173,190,17,90,10,1,C
244G,244G,15,227,240,13,90,10,1,C
244G,244G,15,250,288,38,90,10,1,C
244G,244G,15,310,352,42,90,10,1,C
244G,244G,15,389,416,27,90,10,1,C
244G,244G,15,432,454,22,90,10,1,C
244G,244G,15,466,504,38,90,10,1,C
244G,244G,15,518,553,35,90,10,1,C
244G,244G,15,640,652,12,90,10,1,C
244G,244G,15,686,711,25,90,10,1,C
244G,244G,15,722,736,14,90,10,1,C
244G,244G,15,876,908,32,90,10,1,C
244G,244G,15,920,943,23,90,10,1,C
244G,244G,15,950,968,18,90,10,1,C
244G,244G,15,1040,1100,60,90,10,1,C
244G,244G,15,1212,1224,12,90,10,1,C
244G,244G,15,1236,1250,14,90,10,1,C
244G,244G,15,1255,1265,10,90,10,1,C
244G,244G,15,1415,1450,35,90,10,1,C
244G,244G,15,1509,1530,21,90,10,1,C
244G,244G,15,1592,1635,43,90,10,1,C
244G,244G,15,1649,1679,30,90,10,1,C
244G,244G,15,1730,1749,19,90,10,1,C
244G,244G,15,1754,1777,23,90,10,1,C
244G,244G,15,1825,1857,32,90,10,1,C
244G,244G,15,1928,1960,32,90,10,1,C
244G,244G,15,1980,2006,26,90,10,1,C
244G,244G,15,2062,2101,39,90,10,1,C
244G,244G,15,2243,2300,57,90,10,1,C
244G,244G,15,2356,2370,14,90,10,1,C
244G,244G,15,2385,2420,35,90,10,1,C
244G,244G,15,2598,2610,12,90,10,1,C
244G,244G,15,2680,2690,10,90,10,1,C
244G,244G,15,2740,2762,22,90,10,1,C
244G,244G,15,2770,2795,25,90,10,1,C
244G,244G,15,2807,2823,16,90,10,1,C
244G,244G,15,2839,2895,56,90,10,1,C
244G,244G,15,2912,2932,20,90,10,1,C
244G,244G,15,2947,2962,15,90,10,1,C
244G,244G,28,0,34,34,90,10,1,C
244G,244G,28,40,110,70,90,10,1,C
244G,244G,28,122,146,24,90,10,1,C
244G,244G,28,163,235,72,90,10,1,C
244G,244G,28,245,361,116,90,10,1,C
244G,244G,28,390,480,90,90,10,1,C
244G,244G,28,485,513,28,90,10,1,C
244G,244G,28,534,546,12,90,10,1,C
244G,244G,28,581,641,60,90,10,1,C
244G,244G,28,663,690,27,90,10,1,C
244G,244G,28,709,724,15,90,10,1,C
244G,244G,28,750,766,16,90,10,1,C
244G,244G,28,890,904,14,90,10,1,C
244G,244G,28,915,930,15,90,10,1,C
244G,244G,28,935,947,12,90,10,1,C
244G,244G,28,959,997,38,90,10,1,C
244G,244G,28,1019,1040,21,90,10,1,C
244G,244G,28,1050,1070,20,90,10,1,C
244G,244G,28,1090,1126,36,90,10,1,C
244G,244G,28,1133,1160,27,90,10,1,C
244G,244G,28,1167,1183,16,90,10,1,C
244G,244G,28,1202,1230,28,90,10,1,C
244G,244G,28,1290,1331,41,90,10,1,C
244G,244G,28,1375,1402,27,90,10,1,C
244G,244G,28,1470,1518,48,90,10,1,C
244G,244G,28,1532,1544,12,90,10,1,C
244G,244G,28,1585,1596,11,90,10,1,C
244G,244G,28,1630,1640,10,90,10,1,C
244G,244G,28,1660,1675,15,90,10,1,C
244G,244G,28,1842,1863,21,90,10,1,C
244G,244G,28,1940,1960,20,90,10,1,C
244G,244G,28,1980,2012,32,90,10,1,C
244G,244G,28,2093,2104,11,90,10,1,C
244G,244G,28,2111,2135,24,90,10,1,C
244G,244G,28,2145,2158,13,90,10,1,C
244G,244G,28,2272,2293,21,90,10,1,C
244G,244G,28,2319,2344,25,90,10,1,C
244G,244G,28,2471,2493,22,90,10,1,C
244G,244G,28,2572,2610,38,90,10,1,C
244G,244G,28,2643,2681,38,90,10,1,C
244G,244G,28,2700,2746,46,90,10,1,C
244G,244G,28,2827,2876,49,90,10,1,C
244G,244G,28,2954,2967,13,90,10,1,C
244G,244G,28,2990,3000,10,90,10,1,C
245A,245A,2,119,132,13,90,10,1,C
245A,245A,2,208,229,21,90,10,1,C
245A,245A,2,256,280,24,90,10,1,C
245A,245A,2,300,312,12,90,10,1,C
245A,245A,2,326,338,12,90,10,1,C
245A,245A,2,467,482,15,90,10,1,C
245A,245A,2,664,683,19,90,10,1,C
245A,245A,2,695,710,15,90,10,1,C
245A,245A,2,818,916,98,90,10,1,C
245A,245A,2,934,950,16,90,10,1,C
245A,245A,2,955,970,15,90,10,1,C
245A,245A,2,984,1035,51,90,10,1,C
245A,245A,2,1040,1051,11,90,10,1,C
245A,245A,2,1608,1623,15,90,10,1,C
245A,245A,2,1815,1840,25,90,10,1,C
245A,245A,2,1889,1900,11,90,10,1,C
245A,245A,2,1922,1940,18,90,10,1,C
245A,245A,2,2005,2030,25,90,10,1,C
245A,245A,2,2075,2098,23,90,10,1,C
245A,245A,2,2111,2195,84,90,10,1,C
245A,245A,2,2205,2240,35,90,10,1,C
245A,245A,2,2249,2264,15,90,10,1,C
245A,245A,2,2289,2320,31,90,10,1,C
245A,245A,2,2395,2413,18,90,10,1,C
245A,245A,2,2454,2504,50,90,10,1,C
245A,245A,2,2515,2536,21,90,10,1,C
245A,245A,2,2576,2590,14,90,10,1,C
245A,245A,2,2615,2632,17,90,10,1,C
245A,245A,2,2676,2693,17,90,10,1,C
245A,245A,2,2750,2784,34,90,10,1,C
245A,245A,15,390,405,15,90,10,1,C
245A,245A,15,1047,1058,11,90,10,1,C
245A,245A,15,1165,1176,11,90,10,1,C
245A,245A,15,1339,1351,12,90,10,1,C
245A,245A,15,1409,1422,13,90,10,1,C
245A,245A,15,1430,1458,28,90,10,1,C
245A,245A,15,1525,1535,10,90,10,1,C
245A,245A,15,1576,1589,13,90,10,1,C
245A,245A,15,1670,1682,12,90,10,1,C
245A,245A,15,1755,1770,15,90,10,1,C
245A,245A,15,1877,1888,11,90,10,1,C
245A,245A,15,2160,2172,12,90,10,1,C
245A,245A,15,2210,2223,13,90,10,1,C
245A,245A,15,2232,2317,85,90,10,1,C
245A,245A,15,2524,2536,12,90,10,1,C
245A,245A,15,2664,2674,10,90,10,1,C
245A,245A,15,2895,2912,17,90,10,1,C
245A,245A,15,2970,2982,12,90,10,1,C
245A,245A,28,31,47,16,90,10,1,C
245A,245A,28,142,157,15,90,10,1,C
245A,245A,28,191,217,26,90,10,1,C
245A,245A,28,352,380,28,90,10,1,C
245A,245A,28,476,491,15,90,10,1,C
245A,245A,28,565,596,31,90,10,1,C
245A,245A,28,601,613,12,90,10,1,C
245A,245A,28,650,661,11,90,10,1,C
245A,245A,28,697,711,14,90,10,1,C
245A,245A,28,790,807,17,90,10,1,C
245A,245A,28,1312,1341,29,90,10,1,C
245A,245A,28,1443,1455,12,90,10,1,C
245A,245A,28,1593,1606,13,90,10,1,C
245A,245A,28,1611,1637,26,90,10,1,C
245A,245A,28,1665,1684,19,90,10,1,C
245A,245A,28,1725,1741,16,90,10,1,C
245A,245A,28,1773,1785,12,90,10,1,C
245A,245A,28,1842,1868,26,90,10,1,C
245A,245A,28,1895,1906,11,90,10,1,C
245A,245A,28,1980,1994,14,90,10,1,C
245A,245A,28,2041,2086,45,90,10,1,C
245A,245A,28,2117,2131,14,90,10,1,C
245A,245A,28,2162,2181,19,90,10,1,C
245G,245G,2,84,102,18,90,10,1,C
245G,245G,2,485,507,22,90,10,1,C
245G,245G,2,526,540,14,90,10,1,C
245G,245G,2,563,585,22,90,10,1,C
245G,245G,2,620,634,14,90,10,1,C
245G,245G,2,728,747,19,90,10,1,C
245G,245G,2,815,832,17,90,10,1,C
245G,245G,2,872,882,10,90,10,1,C
245G,245G,2,1140,1158,18,90,10,1,C
245G,245G,2,1169,1179,10,90,10,1,C
245G,245G,2,1243,1317,74,90,10,1,C
245G,245G,2,1338,1353,15,90,10,1,C
245G,245G,2,1396,1413,17,90,10,1,C
245G,245G,2,1440,1458,18,90,10,1,C
245G,245G,2,1720,1732,12,90,10,1,C
245G,245G,2,1837,1859,22,90,10,1,C
245G,245G,2,1900,1940,40,90,10,1,C
245G,245G,2,2020,2050,30,90,10,1,C
245G,245G,2,2112,2129,17,90,10,1,C
245G,245G,2,2151,2161,10,90,10,1,C
245G,245G,2,2224,2236,12,90,10,1,C
245G,245G,2,2261,2274,13,90,10,1,C
245G,245G,2,2322,2336,14,90,10,1,C
245G,245G,2,2468,2492,24,90,10,1,C
245G,245G,2,2542,2553,11,90,10,1,C
245G,245G,2,2873,2883,10,90,10,1,C
245G,245G,2,2970,3000,30,90,10,1,C
245G,245G,15,35,47,12,90,10,1,C
245G,245G,15,81,114,33,90,10,1,C
245G,245G,15,122,137,15,90,10,1,C
245G,245G,15,148,164,16,90,10,1,C
245G,245G,15,255,277,22,90,10,1,C
245G,245G,15,313,330,17,90,10,1,C
245G,245G,15,480,501,21,90,10,1,C
245G,245G,15,690,713,23,90,10,1,C
245G,245G,15,720,745,25,90,10,1,C
245G,245G,15,899,920,21,90,10,1,C
245G,245G,15,1200,1225,25,90,10,1,C
245G,245G,15,1266,1285,19,90,10,1,C
245G,245G,15,1293,1309,16,90,10,1,C
245G,245G,15,1322,1355,33,90,10,1,C
245G,245G,15,1406,1438,32,90,10,1,C
245G,245G,15,1558,1586,28,90,10,1,C
245G,245G,15,1600,1610,10,90,10,1,C
245G,245G,15,1633,1650,17,90,10,1,C
245G,245G,15,1817,1839,22,90,10,1,C
245G,245G,15,1885,1904,19,90,10,1,C
245G,245G,15,2004,2039,35,90,10,1,C
245G,245G,15,2044,2054,10,90,10,1,C
245G,245G,15,2152,2180,28,90,10,1,C
245G,245G,15,2356,2380,24,90,10,1,C
245G,245G,15,2456,2487,31,90,10,1,C
245G,245G,15,2515,2527,12,90,10,1,C
245G,245G,15,2534,2558,24,90,10,1,C
245G,245G,15,2612,2623,11,90,10,1,C
245G,245G,15,2690,2703,13,90,10,1,C
245G,245G,28,190,204,14,90,10,1,C
245G,245G,28,240,258,18,90,10,1,C
245G,245G,28,513,539,26,90,10,1,C
245G,245G,28,559,580,21,90,10,1,C
245G,245G,28,611,629,18,90,10,1,C
245G,245G,28,636,662,26,90,10,1,C
245G,245G,28,670,683,13,90,10,1,C
245G,245G,28,710,724,14,90,10,1,C
245G,245G,28,741,766,25,90,10,1,C
245G,245G,28,848,860,12,90,10,1,C
245G,245G,28,1133,1145,12,90,10,1,C
245G,245G,28,1168,1178,10,90,10,1,C
245G,245G,28,1364,1381,17,90,10,1,C
245G,245G,28,1432,1465,33,90,10,1,C
245G,245G,28,1482,1506,24,90,10,1,C
245G,245G,28,1571,1592,21,90,10,1,C
245G,245G,28,1623,1640,17,90,10,1,C
245G,245G,28,1666,1681,15,90,10,1,C
245G,245G,28,1693,1704,11,90,10,1,C
245G,245G,28,1915,1951,36,90,10,1,C
245G,245G,28,1962,1986,24,90,10,1,C
245G,245G,28,2105,2123,18,90,10,1,C
245G,245G,28,2129,2141,12,90,10,1,C
245G,245G,28,2151,2169,18,90,10,1,C
245G,245G,28,2222,2244,22,90,10,1,C
245G,245G,28,2862,2880,18,90,10,1,C
